"city","year","births","deaths","domesticmig","internationalmig","naturalinc","netmig","npopchg_","popestimate","residual","msa_code"
"Akron OH",2000,2252,1442,-96,223,810,127,999,695961,62,10420
"Akron OH",2001,8826,6540,-1112,709,2286,-403,2244,698205,361,10420
"Akron OH",2002,8527,6457,-1696,653,2070,-1043,1258,699463,231,10420
"Akron OH",2003,8352,6580,-1199,539,1772,-660,647,700110,-465,10420
"Akron OH",2004,8320,6669,-1920,521,1651,-1399,272,700382,20,10420
"Akron OH",2005,8272,6821,-1762,533,1451,-1229,21,700403,-201,10420
"Akron OH",2006,8124,6447,-3300,548,1677,-2752,-1148,699255,-73,10420
"Akron OH",2007,8518,6416,-2701,483,2102,-2218,-173,699082,-57,10420
"Akron OH",2008,8548,6527,-3079,485,2021,-2594,-529,698553,44,10420
"Albany GA",2000,568,312,-410,52,256,-358,-109,157759,-7,10500
"Albany GA",2001,2493,1335,-500,120,1158,-380,2055,159814,1277,10500
"Albany GA",2002,2276,1305,-1189,47,971,-1142,199,160013,370,10500
"Albany GA",2003,2223,1401,-96,-127,822,-223,1115,161128,516,10500
"Albany GA",2004,2228,1479,-537,196,749,-341,276,161404,-132,10500
"Albany GA",2005,2315,1335,-462,91,980,-371,508,161912,-101,10500
"Albany GA",2006,2447,1393,-85,150,1054,65,1062,162974,-57,10500
"Albany GA",2007,2454,1356,-184,70,1098,-114,967,163941,-17,10500
"Albany GA",2008,2392,1394,-117,101,998,-16,978,164919,-4,10500
"Albany-Schenectady-Troy NY",2000,2403,1837,341,342,566,683,1279,827152,30,10580
"Albany-Schenectady-Troy NY",2001,9437,7707,-123,1327,1730,1204,2169,829321,-765,10580
"Albany-Schenectady-Troy NY",2002,9251,7748,2233,1199,1503,3432,4204,833525,-731,10580
"Albany-Schenectady-Troy NY",2003,9582,7600,4086,893,1982,4979,6020,839545,-941,10580
"Albany-Schenectady-Troy NY",2004,9467,7683,1952,1134,1784,3086,4266,843811,-604,10580
"Albany-Schenectady-Troy NY",2005,9333,7666,604,1083,1667,1687,2550,846361,-804,10580
"Albany-Schenectady-Troy NY",2006,9467,7391,1066,1189,2076,2255,3930,850291,-401,10580
"Albany-Schenectady-Troy NY",2007,9481,7451,-1886,1023,2030,-863,1273,851564,106,10580
"Albany-Schenectady-Troy NY",2008,9937,7434,-1550,1060,2503,-490,2355,853919,342,10580
"Albuquerque NM",2000,2635,1182,-61,600,1453,539,2026,731674,34,10740
"Albuquerque NM",2001,10813,5426,877,2096,5387,2973,7653,739327,-707,10740
"Albuquerque NM",2002,10915,5688,7389,1778,5227,9167,13883,753210,-511,10740
"Albuquerque NM",2003,11310,5614,6024,1129,5696,7153,12171,765381,-678,10740
"Albuquerque NM",2004,11180,5863,7942,1889,5317,9831,14370,779751,-778,10740
"Albuquerque NM",2005,11760,5878,10514,1651,5882,12165,17395,797146,-652,10740
"Albuquerque NM",2006,11778,6173,11864,1821,5605,13685,18833,815979,-457,10740
"Albuquerque NM",2007,12489,6257,9468,1501,6232,10969,17065,833044,-136,10740
"Albuquerque NM",2008,12753,6278,4898,1589,6475,6487,12869,845913,-93,10740
"Alexandria LA",2000,547,366,-159,21,181,-138,49,145084,6,10780
"Alexandria LA",2001,2166,1579,-815,80,587,-735,-169,144915,-21,10780
"Alexandria LA",2002,2154,1497,-471,62,657,-409,208,145123,-40,10780
"Alexandria LA",2003,2092,1604,1,13,488,14,395,145518,-107,10780
"Alexandria LA",2004,2170,1546,71,78,624,149,790,146308,17,10780
"Alexandria LA",2005,2152,1571,137,57,581,194,742,147050,-33,10780
"Alexandria LA",2006,2181,1548,2410,74,633,2484,5095,152145,1978,10780
"Alexandria LA",2007,2292,1574,-610,45,718,-565,511,152656,358,10780
"Alexandria LA",2008,2257,1567,-357,53,690,-304,449,153105,63,10780
"Allentown-Bethlehem-Easton PA-NJ",2000,2129,1657,553,399,472,952,1471,741873,47,10900
"Allentown-Bethlehem-Easton PA-NJ",2001,8653,7345,4161,1569,1308,5730,6650,748523,-388,10900
"Allentown-Bethlehem-Easton PA-NJ",2002,8518,7397,5131,1494,1121,6625,7383,755906,-363,10900
"Allentown-Bethlehem-Easton PA-NJ",2003,8845,7284,6853,1299,1561,8152,9371,765277,-342,10900
"Allentown-Bethlehem-Easton PA-NJ",2004,9137,7539,7487,1245,1598,8732,9866,775143,-464,10900
"Allentown-Bethlehem-Easton PA-NJ",2005,9117,7509,7264,1282,1608,8546,9671,784814,-483,10900
"Allentown-Bethlehem-Easton PA-NJ",2006,9157,7460,6573,1599,1697,8172,9618,794432,-251,10900
"Allentown-Bethlehem-Easton PA-NJ",2007,9548,7363,4328,1397,2185,5725,8064,802496,154,10900
"Allentown-Bethlehem-Easton PA-NJ",2008,9768,7450,1674,1400,2318,3074,5714,808210,322,10900
"Altoona PA",2000,365,341,-148,6,24,-142,-112,129032,6,11020
"Altoona PA",2001,1485,1660,-437,28,-175,-409,-697,128335,-113,11020
"Altoona PA",2002,1413,1683,-646,24,-270,-622,-994,127341,-102,11020
"Altoona PA",2003,1483,1603,-236,13,-120,-223,-504,126837,-161,11020
"Altoona PA",2004,1441,1591,-100,28,-150,-72,-308,126529,-86,11020
"Altoona PA",2005,1449,1656,-341,22,-207,-319,-647,125882,-121,11020
"Altoona PA",2006,1426,1578,-172,27,-152,-145,-353,125529,-56,11020
"Altoona PA",2007,1448,1587,-101,19,-139,-82,-187,125342,34,11020
"Altoona PA",2008,1488,1553,-201,19,-65,-182,-168,125174,79,11020
"Amarillo TX",2000,906,472,19,124,434,143,576,227098,-1,11100
"Amarillo TX",2001,3575,1943,-765,549,1632,-216,1194,228292,-222,11100
"Amarillo TX",2002,3505,2081,165,519,1424,684,1869,230161,-239,11100
"Amarillo TX",2003,3694,2108,783,444,1586,1227,2546,232707,-267,11100
"Amarillo TX",2004,3873,2050,287,430,1823,717,2308,235015,-232,11100
"Amarillo TX",2005,3801,2074,639,438,1727,1077,2629,237644,-175,11100
"Amarillo TX",2006,3796,1995,40,444,1801,484,2160,239804,-125,11100
"Amarillo TX",2007,3954,2032,77,404,1922,481,2320,242124,-83,11100
"Amarillo TX",2008,3983,2028,-487,409,1955,-78,1714,243838,-163,11100
"Ames IA",2000,204,104,-85,121,100,36,140,80121,4,11180
"Ames IA",2001,984,473,-1044,519,511,-525,-69,80052,-55,11180
"Ames IA",2002,898,438,667,486,460,1153,1555,81607,-58,11180
"Ames IA",2003,953,484,-982,436,469,-546,-126,81481,-49,11180
"Ames IA",2004,900,450,-325,413,450,88,476,81957,-62,11180
"Ames IA",2005,881,493,-846,426,388,-420,-105,81852,-73,11180
"Ames IA",2006,1013,455,700,438,558,1138,1653,83505,-43,11180
"Ames IA",2007,1027,485,848,397,542,1245,1801,85306,14,11180
"Ames IA",2008,1061,484,450,397,577,847,1448,86754,24,11180
"Anchorage AK",2000,1226,356,-397,290,870,-107,768,320374,5,11260
"Anchorage AK",2001,4992,1414,1461,553,3578,2014,5274,325648,-318,11260
"Anchorage AK",2002,4959,1594,3539,29,3365,3568,6709,332357,-224,11260
"Anchorage AK",2003,5009,1535,4041,-1008,3474,3033,6308,338665,-199,11260
"Anchorage AK",2004,5435,1460,2054,1144,3975,3198,6833,345498,-340,11260
"Anchorage AK",2005,5364,1603,1748,413,3761,2161,5630,351128,-292,11260
"Anchorage AK",2006,5601,1591,3058,810,4010,3868,7684,358812,-194,11260
"Anchorage AK",2007,5903,1624,-3349,323,4279,-3026,1277,360089,24,11260
"Anchorage AK",2008,5842,1694,86,510,4148,596,4612,364701,-132,11260
"Anderson IN",2000,411,345,-174,21,66,-153,-80,133278,7,11300
"Anderson IN",2001,1641,1506,-388,91,135,-297,-286,132992,-124,11300
"Anderson IN",2002,1696,1498,-708,86,198,-622,-534,132458,-110,11300
"Anderson IN",2003,1566,1395,-931,68,171,-863,-831,131627,-139,11300
"Anderson IN",2004,1659,1458,-597,69,201,-528,-429,131198,-102,11300
"Anderson IN",2005,1584,1486,-649,70,98,-579,-595,130603,-114,11300
"Anderson IN",2006,1648,1386,135,74,262,209,409,131012,-62,11300
"Anderson IN",2007,1627,1450,-125,63,177,-62,145,131157,30,11300
"Anderson IN",2008,1649,1455,1,63,194,64,344,131501,86,11300
"Anderson SC",2000,552,376,367,26,176,393,575,166313,6,11340
"Anderson SC",2001,2268,1747,1854,126,521,1980,2377,168690,-124,11340
"Anderson SC",2002,2145,1796,857,118,349,975,1184,169874,-140,11340
"Anderson SC",2003,2207,1821,968,96,386,1064,1258,171132,-192,11340
"Anderson SC",2004,2210,1834,1112,108,376,1220,1456,172588,-140,11340
"Anderson SC",2005,2205,1808,1285,107,397,1392,1644,174232,-145,11340
"Anderson SC",2006,2328,1862,2245,110,466,2355,2726,176958,-95,11340
"Anderson SC",2007,2475,1866,2295,98,609,2393,3006,179964,4,11340
"Anderson SC",2008,2369,1924,2294,101,445,2395,2861,182825,21,11340
"Ann Arbor MI",2000,1103,436,466,572,667,1038,1718,324488,13,11460
"Ann Arbor MI",2001,4110,1869,641,2206,2241,2847,4751,329239,-337,11460
"Ann Arbor MI",2002,4207,1783,242,2073,2424,2315,4397,333636,-342,11460
"Ann Arbor MI",2003,4213,1879,-206,1827,2334,1621,3457,337093,-498,11460
"Ann Arbor MI",2004,4268,1877,-190,1653,2391,1463,3632,340725,-222,11460
"Ann Arbor MI",2005,4239,1842,-540,1743,2397,1203,3300,344025,-300,11460
"Ann Arbor MI",2006,4228,1860,-1778,1735,2368,-43,2160,346185,-165,11460
"Ann Arbor MI",2007,4245,1841,-2227,1582,2404,-645,1784,347969,25,11460
"Ann Arbor MI",2008,4253,1883,-4674,1583,2370,-3091,-593,347376,128,11460
"Anniston-Oxford AL",2000,371,309,-959,14,62,-945,-897,111346,-14,11500
"Anniston-Oxford AL",2001,1561,1388,-481,60,173,-421,-345,111001,-97,11500
"Anniston-Oxford AL",2002,1492,1321,-311,49,171,-262,-187,110814,-96,11500
"Anniston-Oxford AL",2003,1413,1213,400,27,200,427,494,111308,-133,11500
"Anniston-Oxford AL",2004,1521,1313,24,55,208,79,212,111520,-75,11500
"Anniston-Oxford AL",2005,1514,1345,322,43,169,365,433,111953,-101,11500
"Anniston-Oxford AL",2006,1490,1371,511,53,119,564,628,112581,-55,11500
"Anniston-Oxford AL",2007,1505,1296,3,44,209,47,275,112856,19,11500
"Anniston-Oxford AL",2008,1544,1317,228,45,227,273,563,113419,63,11500
"Appleton WI",2000,724,297,301,50,427,351,789,202509,11,11540
"Appleton WI",2001,2854,1344,1259,236,1510,1495,2818,205327,-187,11540
"Appleton WI",2002,2847,1342,1229,226,1505,1455,2785,208112,-175,11540
"Appleton WI",2003,2930,1397,658,193,1533,851,2114,210226,-270,11540
"Appleton WI",2004,2995,1394,291,181,1601,472,1935,212161,-138,11540
"Appleton WI",2005,2923,1451,485,192,1472,677,1959,214120,-190,11540
"Appleton WI",2006,2904,1397,410,194,1507,604,2005,216125,-106,11540
"Appleton WI",2007,3028,1437,-40,170,1591,130,1715,217840,-6,11540
"Appleton WI",2008,3050,1422,34,169,1628,203,1880,219720,49,11540
"Asheville NC",2000,1089,941,930,214,148,1144,1281,370451,-11,11700
"Asheville NC",2001,4449,4232,2548,870,217,3418,3315,373766,-320,11700
"Asheville NC",2002,4398,4174,3106,817,224,3923,3878,377644,-269,11700
"Asheville NC",2003,4381,4222,3552,703,159,4255,4125,381769,-289,11700
"Asheville NC",2004,4526,4217,3947,668,309,4615,4551,386320,-373,11700
"Asheville NC",2005,4463,4440,4087,697,23,4784,4469,390789,-338,11700
"Asheville NC",2006,4627,4282,5363,701,345,6064,6196,396985,-213,11700
"Asheville NC",2007,4970,4361,5253,628,609,5881,6543,403528,53,11700
"Asheville NC",2008,5003,4401,3601,637,602,4238,4908,408436,68,11700
"Athens-Clarke County GA",2000,495,252,355,204,243,559,808,166883,6,12020
"Athens-Clarke County GA",2001,2106,1173,644,780,933,1424,2198,169081,-159,12020
"Athens-Clarke County GA",2002,2208,1124,164,720,1084,884,1833,170914,-135,12020
"Athens-Clarke County GA",2003,2288,1143,1340,593,1145,1933,2909,173823,-169,12020
"Athens-Clarke County GA",2004,2255,1265,2776,640,990,3416,4199,178022,-207,12020
"Athens-Clarke County GA",2005,2359,1108,-927,635,1251,-292,822,178844,-137,12020
"Athens-Clarke County GA",2006,2360,1190,2115,672,1170,2787,3858,182702,-99,12020
"Athens-Clarke County GA",2007,2546,1227,1738,595,1319,2333,3616,186318,-36,12020
"Athens-Clarke County GA",2008,2595,1235,994,605,1360,1599,2946,189264,-13,12020
"Atlanta-Sandy Springs-Marietta GA",2000,17362,6390,15829,7347,10972,23176,33882,4281896,-266,12060
"Atlanta-Sandy Springs-Marietta GA",2001,73107,27332,47792,27840,45775,75632,150686,4432582,29279,12060
"Atlanta-Sandy Springs-Marietta GA",2002,73229,27371,26219,26014,45858,52233,122187,4554769,24096,12060
"Atlanta-Sandy Springs-Marietta GA",2003,74391,27657,22507,22445,46734,44952,117565,4672334,25879,12060
"Atlanta-Sandy Springs-Marietta GA",2004,76606,28364,32297,21163,48242,53460,128931,4801265,27229,12060
"Atlanta-Sandy Springs-Marietta GA",2005,77733,27827,51462,21999,49906,73461,144508,4945773,21141,12060
"Atlanta-Sandy Springs-Marietta GA",2006,80987,28686,95661,22215,52301,117876,168151,5113924,-2026,12060
"Atlanta-Sandy Springs-Marietta GA",2007,82946,30248,75098,20060,52698,95158,147372,5261296,-484,12060
"Atlanta-Sandy Springs-Marietta GA",2008,84080,31165,43051,20184,52915,63235,114989,5376285,-1161,12060
"Atlantic City-Hammonton NJ",2000,800,553,-157,321,247,164,428,252980,17,12100
"Atlantic City-Hammonton NJ",2001,3389,2496,-162,1324,893,1162,1803,254783,-252,12100
"Atlantic City-Hammonton NJ",2002,3498,2714,1431,1236,784,2667,3226,258009,-225,12100
"Atlantic City-Hammonton NJ",2003,3551,2850,2081,1093,701,3174,3612,261621,-263,12100
"Atlantic City-Hammonton NJ",2004,3493,2683,2587,1047,810,3634,4199,265820,-245,12100
"Atlantic City-Hammonton NJ",2005,3613,2513,383,1072,1100,1455,2300,268120,-255,12100
"Atlantic City-Hammonton NJ",2006,3551,2535,-864,1182,1016,318,1209,269329,-125,12100
"Atlantic City-Hammonton NJ",2007,3620,2446,-1697,1073,1174,-624,641,269970,91,12100
"Atlantic City-Hammonton NJ",2008,3681,2550,-1672,1078,1131,-594,711,270681,174,12100
"Auburn-Opelika AL",2000,332,180,203,45,152,248,406,115530,6,12220
"Auburn-Opelika AL",2001,1377,784,548,180,593,728,1208,116738,-113,12220
"Auburn-Opelika AL",2002,1355,776,757,153,579,910,1389,118127,-100,12220
"Auburn-Opelika AL",2003,1393,773,790,111,620,901,1393,119520,-128,12220
"Auburn-Opelika AL",2004,1419,826,1381,166,593,1547,2022,121542,-118,12220
"Auburn-Opelika AL",2005,1475,776,2844,146,699,2990,3590,125132,-99,12220
"Auburn-Opelika AL",2006,1568,852,1983,166,716,2149,2793,127925,-72,12220
"Auburn-Opelika AL",2007,1638,843,1675,143,795,1818,2596,130521,-17,12220
"Auburn-Opelika AL",2008,1658,865,1557,146,793,1703,2489,133010,-7,12220
"Augusta-Richmond County GA-SC",2000,1696,1057,-321,234,639,-87,561,500217,9,12260
"Augusta-Richmond County GA-SC",2001,7588,4536,-315,411,3052,96,2665,502882,-483,12260
"Augusta-Richmond County GA-SC",2002,7340,4615,1126,-34,2725,1092,3393,506275,-424,12260
"Augusta-Richmond County GA-SC",2003,7113,4640,2095,-1015,2473,1080,3010,509285,-543,12260
"Augusta-Richmond County GA-SC",2004,7252,4661,1780,962,2591,2742,4833,514118,-500,12260
"Augusta-Richmond County GA-SC",2005,7413,4568,234,300,2845,534,2961,517079,-418,12260
"Augusta-Richmond County GA-SC",2006,7574,4604,1611,674,2970,2285,4993,522072,-262,12260
"Augusta-Richmond County GA-SC",2007,7920,4760,2929,228,3160,3157,6240,528312,-77,12260
"Augusta-Richmond County GA-SC",2008,7768,4914,2739,395,2854,3134,5906,534218,-82,12260
"Austin-Round Rock TX",2000,5231,1519,10031,2305,3712,12336,15918,1265665,-130,12420
"Austin-Round Rock TX",2001,22086,6610,34655,9063,15476,43718,58679,1324344,-515,12420
"Austin-Round Rock TX",2002,22518,6567,4780,8527,15951,13307,28778,1353122,-480,12420
"Austin-Round Rock TX",2003,22560,6609,6916,7377,15951,14293,29553,1382675,-691,12420
"Austin-Round Rock TX",2004,23284,6980,14624,6849,16304,21473,36462,1419137,-1315,12420
"Austin-Round Rock TX",2005,23686,6733,22537,7170,16953,29707,45426,1464563,-1234,12420
"Austin-Round Rock TX",2006,24483,7204,38918,7197,17279,46115,62477,1527040,-917,12420
"Austin-Round Rock TX",2007,25749,7400,40561,6524,18349,47085,65550,1592590,116,12420
"Austin-Round Rock TX",2008,26725,7819,35041,6552,18906,41593,60012,1652602,-487,12420
"Bakersfield CA",2000,2833,996,-921,892,1837,-29,1857,663510,49,12540
"Bakersfield CA",2001,11719,4916,1411,3165,6803,4576,10725,674235,-654,12540
"Bakersfield CA",2002,11950,4979,6117,2807,6971,8924,15382,689617,-513,12540
"Bakersfield CA",2003,12537,5253,9063,2085,7284,11148,18056,707673,-376,12540
"Bakersfield CA",2004,13169,5452,9818,2634,7717,12452,19395,727068,-774,12540
"Bakersfield CA",2005,13709,5195,11370,2517,8514,13887,21698,748766,-703,12540
"Bakersfield CA",2006,14645,5509,10129,2611,9136,12740,21455,770221,-421,12540
"Bakersfield CA",2007,15296,5403,4727,2236,9893,6963,16958,787179,102,12540
"Bakersfield CA",2008,15820,5473,390,2325,10347,2715,13279,800458,217,12540
"Baltimore-Towson MD",2000,8641,5537,-458,1603,3104,1145,4238,2557238,-11,12580
"Baltimore-Towson MD",2001,34227,24002,-235,5007,10225,4772,20174,2577412,5177,12580
"Baltimore-Towson MD",2002,33875,23705,4108,3907,10170,8015,21894,2599306,3709,12580
"Baltimore-Towson MD",2003,33881,23743,3556,1877,10138,5433,21113,2620419,5542,12580
"Baltimore-Towson MD",2004,34513,23329,-6434,4824,11184,-1610,15753,2636172,6179,12580
"Baltimore-Towson MD",2005,34340,23402,-5883,3817,10938,-2066,10819,2646991,1947,12580
"Baltimore-Towson MD",2006,34886,22870,-6573,4526,12016,-2047,11031,2658022,1062,12580
"Baltimore-Towson MD",2007,35397,23541,-11158,3522,11856,-7636,5783,2663805,1563,12580
"Baltimore-Towson MD",2008,35375,23422,-12352,3758,11953,-8594,3312,2667117,-47,12580
"Bangor ME",2000,389,324,-121,29,65,-92,-15,144904,12,12620
"Bangor ME",2001,1572,1368,479,118,204,597,668,145572,-133,12620
"Bangor ME",2002,1476,1343,534,97,133,631,635,146207,-129,12620
"Bangor ME",2003,1557,1394,798,55,163,853,854,147061,-162,12620
"Bangor ME",2004,1573,1340,-727,112,233,-615,-495,146566,-113,12620
"Bangor ME",2005,1621,1445,212,91,176,303,336,146902,-143,12620
"Bangor ME",2006,1603,1439,741,104,164,845,937,147839,-72,12620
"Bangor ME",2007,1655,1289,252,84,366,336,688,148527,-14,12620
"Bangor ME",2008,1698,1315,-354,90,383,-264,124,148651,5,12620
"Barnstable Town MA",2000,509,673,1090,109,-164,1199,996,223228,-39,12700
"Barnstable Town MA",2001,2023,2744,2294,406,-721,2700,1814,225042,-165,12700
"Barnstable Town MA",2002,1995,2756,2521,326,-761,2847,1960,227002,-126,12700
"Barnstable Town MA",2003,2000,2786,1907,188,-786,2095,1133,228135,-176,12700
"Barnstable Town MA",2004,1940,2867,-582,360,-927,-222,-1306,226829,-157,12700
"Barnstable Town MA",2005,1976,2707,-1275,296,-731,-979,-1916,224913,-206,12700
"Barnstable Town MA",2006,1931,2706,-1067,345,-775,-722,-1598,223315,-101,12700
"Barnstable Town MA",2007,1980,2734,-866,270,-754,-596,-1325,221990,25,12700
"Barnstable Town MA",2008,1986,2750,-542,282,-764,-260,-941,221049,83,12700
"Baton Rouge LA",2000,2611,1285,-137,246,1326,109,1441,707343,6,12940
"Baton Rouge LA",2001,10540,5588,-3015,955,4952,-2060,2375,709718,-517,12940
"Baton Rouge LA",2002,10320,5705,-1424,883,4615,-541,3638,713356,-436,12940
"Baton Rouge LA",2003,10198,5758,967,738,4440,1705,5494,718850,-651,12940
"Baton Rouge LA",2004,10406,5870,1744,740,4536,2484,6362,725212,-658,12940
"Baton Rouge LA",2005,10307,5924,-358,751,4383,393,4154,729366,-622,12940
"Baton Rouge LA",2006,10759,6261,29476,771,4498,30247,34222,763588,-523,12940
"Baton Rouge LA",2007,11504,6224,-19,689,5280,670,5809,769397,-141,12940
"Baton Rouge LA",2008,11351,6269,-598,700,5082,102,4930,774327,-254,12940
"Battle Creek MI",2000,460,350,-128,35,110,-93,27,138012,10,12980
"Battle Creek MI",2001,1923,1429,-554,175,494,-379,-7,138005,-122,12980
"Battle Creek MI",2002,1855,1500,-130,165,355,35,260,138265,-130,12980
"Battle Creek MI",2003,1915,1459,-251,139,456,-112,153,138418,-191,12980
"Battle Creek MI",2004,1888,1399,-210,155,489,-55,336,138754,-98,12980
"Battle Creek MI",2005,1849,1387,-1188,148,462,-1040,-694,138060,-116,12980
"Battle Creek MI",2006,1818,1394,-1387,154,424,-1233,-868,137192,-59,12980
"Battle Creek MI",2007,1881,1396,-1507,136,485,-1371,-858,136334,28,12980
"Battle Creek MI",2008,1882,1346,-1146,137,536,-1009,-473,135861,0,12980
"Bay City MI",2000,335,281,-130,5,54,-125,-67,110090,4,13020
"Bay City MI",2001,1319,1095,-594,25,224,-569,-439,109651,-94,13020
"Bay City MI",2002,1326,1115,-203,19,211,-184,-75,109576,-102,13020
"Bay City MI",2003,1230,1114,-451,8,116,-443,-454,109122,-127,13020
"Bay City MI",2004,1309,1122,-329,28,187,-301,-193,108929,-79,13020
"Bay City MI",2005,1230,1104,-442,19,126,-423,-398,108531,-101,13020
"Bay City MI",2006,1233,1075,-741,25,158,-716,-604,107927,-46,13020
"Bay City MI",2007,1273,1106,-759,18,167,-741,-561,107366,13,13020
"Bay City MI",2008,1282,1058,-118,19,224,-99,129,107495,4,13020
"Beaumont-Port Arthur TX",2000,1146,935,-785,146,211,-639,-425,384665,3,13140
"Beaumont-Port Arthur TX",2001,5195,4009,-4494,603,1186,-3891,-2987,381678,-282,13140
"Beaumont-Port Arthur TX",2002,5150,3957,-2186,566,1193,-1620,-730,380948,-303,13140
"Beaumont-Port Arthur TX",2003,5139,3845,-2321,478,1294,-1843,-961,379987,-412,13140
"Beaumont-Port Arthur TX",2004,5147,3923,-1046,472,1224,-574,355,380342,-295,13140
"Beaumont-Port Arthur TX",2005,5219,3980,-1414,485,1239,-929,-23,380319,-333,13140
"Beaumont-Port Arthur TX",2006,4894,3995,-7726,493,899,-7233,-6472,373847,-138,13140
"Beaumont-Port Arthur TX",2007,5363,3793,713,433,1570,1146,2601,376448,-115,13140
"Beaumont-Port Arthur TX",2008,5160,3833,143,441,1327,584,1807,378255,-104,13140
"Bellingham WA",2000,556,301,469,179,255,648,898,167726,-5,13380
"Bellingham WA",2001,1990,1241,2216,648,749,2864,3470,171196,-143,13380
"Bellingham WA",2002,1942,1218,2489,602,724,3091,3692,174888,-123,13380
"Bellingham WA",2003,2043,1356,1771,524,687,2295,2811,177699,-171,13380
"Bellingham WA",2004,2070,1312,2810,501,758,3311,3876,181575,-193,13380
"Bellingham WA",2005,2077,1337,2491,518,740,3009,3605,185180,-144,13380
"Bellingham WA",2006,2171,1310,1834,517,861,2351,3109,188289,-103,13380
"Bellingham WA",2007,2266,1361,2736,468,905,3204,4064,192353,-45,13380
"Bellingham WA",2008,2401,1372,2725,472,1029,3197,4176,196529,-50,13380
"Bend OR",2000,365,200,1083,24,165,1107,1246,116613,-26,13460
"Bend OR",2001,1460,951,3481,92,509,3573,4032,120645,-50,13460
"Bend OR",2002,1444,966,4251,88,478,4339,4795,125440,-22,13460
"Bend OR",2003,1564,998,3178,68,566,3246,3852,129292,40,13460
"Bend OR",2004,1589,939,4255,76,650,4331,4764,134056,-217,13460
"Bend OR",2005,1721,1052,6227,71,669,6298,6886,140942,-81,13460
"Bend OR",2006,1876,1063,7098,75,813,7173,7885,148827,-101,13460
"Bend OR",2007,2121,1060,3918,66,1061,3984,4972,153799,-73,13460
"Bend OR",2008,2137,1107,3682,66,1030,3748,4657,158456,-121,13460
"Billings MT",2000,463,293,7,4,170,11,190,139092,9,13740
"Billings MT",2001,1825,1230,665,34,595,699,1144,140236,-150,13740
"Billings MT",2002,1812,1285,739,28,527,767,1165,141401,-129,13740
"Billings MT",2003,1850,1295,850,18,555,868,1273,142674,-150,13740
"Billings MT",2004,1932,1233,898,34,699,932,1515,144189,-116,13740
"Billings MT",2005,1984,1307,1425,29,677,1454,2004,146193,-127,13740
"Billings MT",2006,1990,1307,826,31,683,857,1465,147658,-75,13740
"Billings MT",2007,2090,1281,992,26,809,1018,1817,149475,-10,13740
"Billings MT",2008,2071,1296,1706,28,775,1734,2530,152005,21,13740
"Binghamton NY",2000,670,603,-464,93,67,-371,-298,252025,6,13780
"Binghamton NY",2001,2795,2650,-909,386,145,-523,-613,251412,-235,13780
"Binghamton NY",2002,2698,2443,-550,369,255,-181,-157,251255,-231,13780
"Binghamton NY",2003,2637,2552,-1786,326,85,-1460,-1633,249622,-258,13780
"Binghamton NY",2004,2695,2533,-1546,309,162,-1237,-1270,248352,-195,13780
"Binghamton NY",2005,2593,2468,-1758,322,125,-1436,-1517,246835,-206,13780
"Binghamton NY",2006,2581,2412,-778,331,169,-447,-395,246440,-117,13780
"Binghamton NY",2007,2788,2546,-1124,302,242,-822,-590,245850,-10,13780
"Binghamton NY",2008,2819,2402,-1351,304,417,-1047,-661,245189,-31,13780
"Birmingham-Hoover AL",2000,3682,2527,517,379,1155,896,2064,1053365,13,13820
"Birmingham-Hoover AL",2001,15135,10688,694,1390,4447,2084,6711,1060076,180,13820
"Birmingham-Hoover AL",2002,14626,10842,-764,1276,3784,512,4404,1064480,108,13820
"Birmingham-Hoover AL",2003,14451,11162,3668,1022,3289,4690,7935,1072415,-44,13820
"Birmingham-Hoover AL",2004,14796,11287,3341,1079,3509,4420,7791,1080206,-138,13820
"Birmingham-Hoover AL",2005,14953,11090,3373,1070,3863,4443,8097,1088303,-209,13820
"Birmingham-Hoover AL",2006,15198,11068,6766,1114,4130,7880,11983,1100286,-27,13820
"Birmingham-Hoover AL",2007,15602,11019,2565,971,4583,3536,8386,1108672,267,13820
"Birmingham-Hoover AL",2008,15440,11077,3302,977,4363,4279,8936,1117608,294,13820
"Bismarck ND",2000,291,195,1,9,96,10,109,94842,3,13900
"Bismarck ND",2001,1149,779,-2,45,370,43,325,95167,-88,13900
"Bismarck ND",2002,1146,761,580,34,385,614,923,96090,-76,13900
"Bismarck ND",2003,1205,767,423,1,438,424,761,96851,-101,13900
"Bismarck ND",2004,1240,749,428,50,491,478,893,97744,-76,13900
"Bismarck ND",2005,1269,689,1121,33,580,1154,1644,99388,-90,13900
"Bismarck ND",2006,1360,766,1183,43,594,1226,1767,101155,-53,13900
"Bismarck ND",2007,1411,759,1292,28,652,1320,1972,103127,0,13900
"Bismarck ND",2008,1473,782,1076,34,691,1110,1817,104944,16,13900
"Blacksburg-Christiansburg-Radford VA",2000,418,293,-50,106,125,56,192,151516,11,13980
"Blacksburg-Christiansburg-Radford VA",2001,1622,1233,849,416,389,1265,1522,153038,-132,13980
"Blacksburg-Christiansburg-Radford VA",2002,1380,1260,-850,389,120,-461,-466,152572,-125,13980
"Blacksburg-Christiansburg-Radford VA",2003,1478,1226,-133,321,252,188,246,152818,-194,13980
"Blacksburg-Christiansburg-Radford VA",2004,1530,1272,-136,326,258,190,341,153159,-107,13980
"Blacksburg-Christiansburg-Radford VA",2005,1453,1266,879,332,187,1211,1257,154416,-141,13980
"Blacksburg-Christiansburg-Radford VA",2006,1425,1266,957,337,159,1294,1376,155792,-77,13980
"Blacksburg-Christiansburg-Radford VA",2007,1633,1266,884,304,367,1188,1564,157356,9,13980
"Blacksburg-Christiansburg-Radford VA",2008,1625,1236,257,304,389,561,972,158328,22,13980
"Bloomington IN",2000,495,302,-16,128,193,112,314,175821,9,14020
"Bloomington IN",2001,1921,1275,-638,489,646,-149,340,176161,-157,14020
"Bloomington IN",2002,1908,1373,-518,449,535,-69,311,176472,-155,14020
"Bloomington IN",2003,1890,1354,889,400,536,1289,1626,178098,-199,14020
"Bloomington IN",2004,1947,1329,265,386,618,651,1145,179243,-124,14020
"Bloomington IN",2005,1904,1316,-109,392,588,283,711,179954,-160,14020
"Bloomington IN",2006,1904,1280,653,401,624,1054,1589,181543,-89,14020
"Bloomington IN",2007,2027,1405,99,361,622,460,1077,182620,-5,14020
"Bloomington IN",2008,2085,1378,237,360,707,597,1324,183944,20,14020
"Bloomington-Normal IL",2000,489,208,82,70,281,152,447,150880,14,14060
"Bloomington-Normal IL",2001,2015,990,552,287,1025,839,1718,152598,-146,14060
"Bloomington-Normal IL",2002,2076,1022,1775,266,1054,2041,2997,155595,-98,14060
"Bloomington-Normal IL",2003,2128,1028,519,227,1100,746,1632,157227,-214,14060
"Bloomington-Normal IL",2004,2179,1068,-88,226,1111,138,1142,158369,-107,14060
"Bloomington-Normal IL",2005,2242,1006,-345,234,1236,-111,980,159349,-145,14060
"Bloomington-Normal IL",2006,2166,1032,994,235,1134,1229,2281,161630,-82,14060
"Bloomington-Normal IL",2007,2251,1059,659,215,1192,874,2062,163692,-4,14060
"Bloomington-Normal IL",2008,2363,1053,33,218,1310,251,1606,165298,45,14060
"Boise City-Nampa ID",2000,1988,781,2492,332,1207,2824,3990,468830,-41,14260
"Boise City-Nampa ID",2001,7957,3089,10784,1284,4868,12068,16671,485501,-265,14260
"Boise City-Nampa ID",2002,8121,3140,7626,1157,4981,8783,13462,498963,-302,14260
"Boise City-Nampa ID",2003,8390,3144,6015,885,5246,6900,11766,510729,-380,14260
"Boise City-Nampa ID",2004,8670,3397,7116,1028,5273,8144,12868,523597,-549,14260
"Boise City-Nampa ID",2005,8898,3504,14300,992,5394,15292,20321,543918,-365,14260
"Boise City-Nampa ID",2006,9420,3624,15999,1034,5796,17033,22468,566386,-361,14260
"Boise City-Nampa ID",2007,9761,3702,13541,895,6059,14436,20214,586600,-281,14260
"Boise City-Nampa ID",2008,9899,3739,6545,917,6160,7462,13153,599753,-469,14260
"Boston-Cambridge-Quincy MA-NH",2000,14942,8398,-3404,6462,6544,3058,9804,4402149,202,14460
"Boston-Cambridge-Quincy MA-NH",2001,58179,36733,-13945,24988,21446,11043,39526,4441675,7037,14460
"Boston-Cambridge-Quincy MA-NH",2002,57470,36436,-35445,23419,21034,-12026,14699,4456374,5691,14460
"Boston-Cambridge-Quincy MA-NH",2003,57014,35964,-47036,20409,21050,-26627,5,4456379,5582,14460
"Boston-Cambridge-Quincy MA-NH",2004,56202,35659,-46821,18995,20543,-27826,-2415,4453964,4868,14460
"Boston-Cambridge-Quincy MA-NH",2005,55300,35089,-46088,19802,20211,-26286,995,4454959,7070,14460
"Boston-Cambridge-Quincy MA-NH",2006,54932,34086,-32988,20554,20846,-12434,12274,4467233,3862,14460
"Boston-Cambridge-Quincy MA-NH",2007,55057,34617,-22508,18524,20440,-3984,25105,4492338,8649,14460
"Boston-Cambridge-Quincy MA-NH",2008,55264,34826,-8261,18569,20438,10308,30520,4522858,-226,14460
"Boulder CO",2000,905,316,859,418,589,1277,1878,271651,12,14500
"Boulder CO",2001,3559,1357,2475,1641,2202,4116,6105,277756,-213,14500
"Boulder CO",2002,3598,1323,-1489,1530,2275,41,2076,279832,-240,14500
"Boulder CO",2003,3525,1450,-3793,1355,2075,-2438,-514,279318,-151,14500
"Boulder CO",2004,3572,1443,-1414,1234,2129,-180,1731,281049,-218,14500
"Boulder CO",2005,3511,1386,-2095,1289,2125,-806,1066,282115,-253,14500
"Boulder CO",2006,3529,1478,-260,1282,2051,1022,2935,285050,-138,14500
"Boulder CO",2007,3427,1412,582,1181,2015,1763,3755,288805,-23,14500
"Boulder CO",2008,3652,1440,971,1183,2212,2154,4356,293161,-10,14500
"Bowling Green KY",2000,335,192,49,96,143,145,297,104465,9,14540
"Bowling Green KY",2001,1366,854,44,381,512,425,832,105297,-105,14540
"Bowling Green KY",2002,1402,934,156,356,468,512,875,106172,-105,14540
"Bowling Green KY",2003,1388,899,865,308,489,1173,1563,107735,-99,14540
"Bowling Green KY",2004,1432,894,729,294,538,1023,1470,109205,-91,14540
"Bowling Green KY",2005,1539,908,1314,304,631,1618,2155,111360,-94,14540
"Bowling Green KY",2006,1529,886,1636,304,643,1940,2523,113883,-60,14540
"Bowling Green KY",2007,1574,914,890,274,660,1164,1815,115698,-9,14540
"Bowling Green KY",2008,1624,955,1303,276,669,1579,2249,117947,1,14540
"Bradenton-Sarasota-Venice FL",2000,1463,1943,2656,556,-480,3212,2667,592633,-65,14600
"Bradenton-Sarasota-Venice FL",2001,5929,8084,12509,2054,-2155,14563,12184,604817,-224,14600
"Bradenton-Sarasota-Venice FL",2002,6015,8113,13700,1860,-2098,15560,13370,618187,-92,14600
"Bradenton-Sarasota-Venice FL",2003,6259,7994,12902,1539,-1735,14441,12860,631047,154,14600
"Bradenton-Sarasota-Venice FL",2004,6507,8030,18424,1630,-1523,20054,17507,648554,-1024,14600
"Bradenton-Sarasota-Venice FL",2005,6538,8274,19777,1616,-1736,21393,19020,667574,-637,14600
"Bradenton-Sarasota-Venice FL",2006,7060,8231,11091,1701,-1171,12792,11266,678840,-355,14600
"Bradenton-Sarasota-Venice FL",2007,7263,8528,5721,1510,-1265,7231,6162,685002,196,14600
"Bradenton-Sarasota-Venice FL",2008,7253,8740,2473,1532,-1487,4005,2821,687823,303,14600
"Bremerton-Silverdale WA",2000,756,414,-172,190,342,18,374,232340,14,14740
"Bremerton-Silverdale WA",2001,2973,1786,-106,123,1187,17,964,233304,-240,14740
"Bremerton-Silverdale WA",2002,2976,1818,2732,-416,1158,2316,3319,236623,-155,14740
"Bremerton-Silverdale WA",2003,3024,1750,2633,-1482,1274,1151,2261,238884,-164,14740
"Bremerton-Silverdale WA",2004,2969,1812,-1499,846,1157,-653,295,239179,-209,14740
"Bremerton-Silverdale WA",2005,2932,1797,-4173,55,1135,-4118,-3155,236024,-172,14740
"Bremerton-Silverdale WA",2006,3016,1716,2115,456,1300,2571,3747,239771,-124,14740
"Bremerton-Silverdale WA",2007,2965,1796,-2836,-16,1169,-2852,-1611,238160,72,14740
"Bremerton-Silverdale WA",2008,2885,1798,242,190,1087,432,1609,239769,90,14740
"Bridgeport-Stamford-Norwalk CT",2000,3175,1631,-1441,1774,1544,333,1914,884481,37,14860
"Bridgeport-Stamford-Norwalk CT",2001,12273,7031,-7586,6854,5242,-732,3745,888226,-765,14860
"Bridgeport-Stamford-Norwalk CT",2002,11926,7039,-7931,6471,4887,-1460,2687,890913,-740,14860
"Bridgeport-Stamford-Norwalk CT",2003,12171,7097,-8081,5723,5074,-2358,1863,892776,-853,14860
"Bridgeport-Stamford-Norwalk CT",2004,12047,6787,-9447,5177,5260,-4270,170,892946,-820,14860
"Bridgeport-Stamford-Norwalk CT",2005,11816,6787,-10881,5446,5029,-5435,-1108,891838,-702,14860
"Bridgeport-Stamford-Norwalk CT",2006,11640,6565,-11663,5671,5075,-5992,-1326,890512,-409,14860
"Bridgeport-Stamford-Norwalk CT",2007,11655,6166,-10259,5144,5489,-5115,83,890595,-291,14860
"Bridgeport-Stamford-Norwalk CT",2008,11270,6331,-5190,5148,4939,-42,4435,895030,-462,14860
"Brownsville-Harlingen TX",2000,1878,436,-718,567,1442,-151,1289,336516,-2,15180
"Brownsville-Harlingen TX",2001,8369,1882,-2445,2184,6487,-261,5933,342449,-293,15180
"Brownsville-Harlingen TX",2002,8453,2135,-585,2052,6318,1467,7419,349868,-366,15180
"Brownsville-Harlingen TX",2003,8692,2004,-216,1790,6688,1574,7727,357595,-535,15180
"Brownsville-Harlingen TX",2004,8634,2030,-809,1657,6604,848,7214,364809,-238,15180
"Brownsville-Harlingen TX",2005,8734,2010,-1404,1728,6724,324,6683,371492,-365,15180
"Brownsville-Harlingen TX",2006,8613,2039,-1424,1733,6574,309,6689,378181,-194,15180
"Brownsville-Harlingen TX",2007,8766,2191,-1463,1571,6575,108,6724,384905,41,15180
"Brownsville-Harlingen TX",2008,9123,2298,-664,1576,6825,912,7831,392736,94,15180
"Brunswick GA",2000,304,222,58,37,82,95,177,93221,0,15260
"Brunswick GA",2001,1261,906,639,132,355,771,1047,94268,-79,15260
"Brunswick GA",2002,1246,937,351,121,309,472,709,94977,-72,15260
"Brunswick GA",2003,1336,995,639,88,341,727,965,95942,-103,15260
"Brunswick GA",2004,1326,1052,425,116,274,541,735,96677,-80,15260
"Brunswick GA",2005,1343,971,479,105,372,584,876,97553,-80,15260
"Brunswick GA",2006,1361,1034,1876,116,327,1992,2266,99819,-53,15260
"Brunswick GA",2007,1378,1032,1213,100,346,1313,1680,101499,21,15260
"Brunswick GA",2008,1410,1020,849,108,390,957,1351,102850,4,15260
"Buffalo-Niagara Falls NY",2000,3466,2908,-1965,367,558,-1598,-997,1169112,43,15380
"Buffalo-Niagara Falls NY",2001,13562,12549,-7063,1482,1013,-5581,-5568,1163544,-1000,15380
"Buffalo-Niagara Falls NY",2002,13098,12401,-6118,1370,697,-4748,-5046,1158498,-995,15380
"Buffalo-Niagara Falls NY",2003,13092,12406,-4248,1142,686,-3106,-3929,1154569,-1509,15380
"Buffalo-Niagara Falls NY",2004,12817,12218,-6071,1157,599,-4914,-5200,1149369,-885,15380
"Buffalo-Niagara Falls NY",2005,12195,12273,-9185,1176,-78,-8009,-9060,1140309,-973,15380
"Buffalo-Niagara Falls NY",2006,12016,11495,-9713,1366,521,-8347,-8320,1131989,-494,15380
"Buffalo-Niagara Falls NY",2007,12515,11868,-7282,1189,647,-6093,-5476,1126513,-30,15380
"Buffalo-Niagara Falls NY",2008,12717,11733,-4485,1203,984,-3282,-2204,1124309,94,15380
"Burlington NC",2000,437,301,385,183,136,568,702,131502,-2,15500
"Burlington NC",2001,1878,1363,876,688,515,1564,1962,133464,-117,15500
"Burlington NC",2002,1874,1247,673,653,627,1326,1844,135308,-109,15500
"Burlington NC",2003,1827,1358,-105,574,469,469,742,136050,-196,15500
"Burlington NC",2004,1834,1314,773,516,520,1289,1697,137747,-112,15500
"Burlington NC",2005,1793,1366,885,549,427,1434,1733,139480,-128,15500
"Burlington NC",2006,1849,1320,1007,548,529,1555,2012,141492,-72,15500
"Burlington NC",2007,1992,1373,2124,497,619,2621,3298,144790,58,15500
"Burlington NC",2008,2038,1349,1997,499,689,2496,3263,148053,78,15500
"Burlington-South Burlington VT",2000,626,319,236,126,307,362,676,199568,7,15540
"Burlington-South Burlington VT",2001,2308,1337,237,496,971,733,1510,201078,-194,15540
"Burlington-South Burlington VT",2002,2235,1357,322,445,878,767,1450,202528,-195,15540
"Burlington-South Burlington VT",2003,2322,1438,-174,370,884,196,823,203351,-257,15540
"Burlington-South Burlington VT",2004,2414,1413,-7,389,1001,382,1239,204590,-144,15540
"Burlington-South Burlington VT",2005,2308,1371,-387,385,937,-2,758,205348,-177,15540
"Burlington-South Burlington VT",2006,2230,1326,-299,402,904,103,907,206255,-100,15540
"Burlington-South Burlington VT",2007,2347,1282,-495,358,1065,-137,965,207220,37,15540
"Burlington-South Burlington VT",2008,2305,1345,-164,358,960,194,1240,208460,86,15540
"Canton-Massillon OH",2000,1332,995,-401,39,337,-362,-2,406966,23,15940
"Canton-Massillon OH",2001,5125,4205,-1541,111,920,-1430,342,407308,852,15940
"Canton-Massillon OH",2002,4772,4044,-961,106,728,-855,499,407807,626,15940
"Canton-Massillon OH",2003,4835,4204,-686,72,631,-614,510,408317,493,15940
"Canton-Massillon OH",2004,4781,4169,-685,70,612,-615,63,408380,66,15940
"Canton-Massillon OH",2005,4690,4195,-1324,73,495,-1251,-825,407555,-69,15940
"Canton-Massillon OH",2006,4811,4059,-1029,76,752,-953,-211,407344,-10,15940
"Canton-Massillon OH",2007,4964,4100,-739,65,864,-674,250,407594,60,15940
"Canton-Massillon OH",2008,5007,4131,-1063,64,876,-999,59,407653,182,15940
"Cape Coral-Fort Myers FL",2000,1211,1159,2477,529,52,3006,2994,443882,-64,15980
"Cape Coral-Fort Myers FL",2001,5246,5236,12814,1922,10,14736,14659,458541,-87,15980
"Cape Coral-Fort Myers FL",2002,5409,5450,13686,1816,-41,15502,15499,474040,38,15980
"Cape Coral-Fort Myers FL",2003,5483,5343,13763,1610,140,15373,15983,490023,470,15980
"Cape Coral-Fort Myers FL",2004,5737,5437,21206,1468,300,22674,21936,511959,-1038,15980
"Cape Coral-Fort Myers FL",2005,6299,5702,27533,1534,597,29067,29200,541159,-464,15980
"Cape Coral-Fort Myers FL",2006,7047,5863,24655,1642,1184,26297,27128,568287,-353,15980
"Cape Coral-Fort Myers FL",2007,7684,6192,16637,1489,1492,18126,19842,588129,224,15980
"Cape Coral-Fort Myers FL",2008,7891,6254,1749,1492,1637,3241,5007,593136,129,15980
"Carson City NV",2000,148,153,38,60,-5,98,89,52546,-4,16180
"Carson City NV",2001,742,561,524,210,181,734,857,53403,-58,16180
"Carson City NV",2002,738,656,731,197,82,928,964,54367,-46,16180
"Carson City NV",2003,703,657,470,169,46,639,626,54993,-59,16180
"Carson City NV",2004,746,633,447,163,113,610,677,55670,-46,16180
"Carson City NV",2005,745,660,-306,169,85,-137,-104,55566,-52,16180
"Carson City NV",2006,766,622,-875,168,144,-707,-583,54983,-20,16180
"Carson City NV",2007,747,671,-501,146,76,-355,-259,54724,20,16180
"Carson City NV",2008,738,627,-151,146,111,-5,143,54867,37,16180
"Casper WY",2000,212,161,-47,13,51,-34,24,66557,7,16220
"Casper WY",2001,889,588,32,41,301,73,306,66863,-68,16220
"Casper WY",2002,920,593,185,37,327,222,490,67353,-59,16220
"Casper WY",2003,903,586,320,26,317,346,586,67939,-77,16220
"Casper WY",2004,994,543,266,34,451,300,698,68637,-53,16220
"Casper WY",2005,1001,592,394,31,409,425,771,69408,-63,16220
"Casper WY",2006,983,627,456,35,356,491,812,70220,-35,16220
"Casper WY",2007,1100,598,1022,30,502,1052,1564,71784,10,16220
"Casper WY",2008,1102,578,798,32,524,830,1345,73129,-9,16220
"Cedar Rapids IA",2000,828,387,93,62,441,155,605,237835,9,16300
"Cedar Rapids IA",2001,3297,1951,613,288,1346,901,2237,240072,-10,16300
"Cedar Rapids IA",2002,3297,1807,244,269,1490,513,1961,242033,-42,16300
"Cedar Rapids IA",2003,3284,1942,-393,237,1342,-156,1065,243098,-121,16300
"Cedar Rapids IA",2004,3323,1940,229,225,1383,454,1908,245006,71,16300
"Cedar Rapids IA",2005,3249,1937,622,228,1312,850,2145,247151,-17,16300
"Cedar Rapids IA",2006,3385,2008,633,231,1377,864,2232,249383,-9,16300
"Cedar Rapids IA",2007,3436,1946,1399,207,1490,1606,3089,252472,-7,16300
"Cedar Rapids IA",2008,3513,1910,1155,205,1603,1360,2980,255452,17,16300
"Champaign-Urbana IL",2000,633,365,-320,270,268,-50,222,210501,4,16580
"Champaign-Urbana IL",2001,2749,1535,-780,1049,1214,269,1289,211790,-194,16580
"Champaign-Urbana IL",2002,2603,1559,-265,991,1044,726,1563,213353,-207,16580
"Champaign-Urbana IL",2003,2576,1527,671,856,1049,1527,2296,215649,-280,16580
"Champaign-Urbana IL",2004,2648,1536,-557,813,1112,256,1211,216860,-157,16580
"Champaign-Urbana IL",2005,2743,1581,-169,845,1162,676,1634,218494,-204,16580
"Champaign-Urbana IL",2006,2878,1526,661,846,1352,1507,2748,221242,-111,16580
"Champaign-Urbana IL",2007,2792,1539,342,770,1253,1112,2344,223586,-21,16580
"Champaign-Urbana IL",2008,2939,1558,-1565,778,1381,-787,605,224191,11,16580
"Charleston WV",2000,944,882,-331,15,62,-316,-248,309387,6,16620
"Charleston WV",2001,3724,3667,-2257,84,57,-2173,-2368,307019,-252,16620
"Charleston WV",2002,3737,3611,-844,64,126,-780,-896,306123,-242,16620
"Charleston WV",2003,3804,3554,165,25,250,190,39,306162,-401,16620
"Charleston WV",2004,3888,3722,-248,86,166,-162,-221,305941,-225,16620
"Charleston WV",2005,3681,3654,-1273,61,27,-1212,-1464,304477,-279,16620
"Charleston WV",2006,3728,3553,-999,81,175,-918,-877,303600,-134,16620
"Charleston WV",2007,3673,3618,-80,65,55,-15,56,303656,16,16620
"Charleston WV",2008,3671,3541,34,64,130,98,288,303944,60,16620
"Charleston-North Charleston-Summerville SC",2000,1901,1077,621,391,824,1012,1869,550841,33,16700
"Charleston-North Charleston-Summerville SC",2001,7956,4447,2317,728,3509,3045,6603,557444,49,16700
"Charleston-North Charleston-Summerville SC",2002,7832,4423,5601,200,3409,5801,9291,566735,81,16700
"Charleston-North Charleston-Summerville SC",2003,8051,4581,7294,-1094,3470,6200,9916,576651,246,16700
"Charleston-North Charleston-Summerville SC",2004,8313,4412,8171,1403,3901,9574,13468,590119,-7,16700
"Charleston-North Charleston-Summerville SC",2005,8521,4522,6322,653,3999,6975,11043,601162,69,16700
"Charleston-North Charleston-Summerville SC",2006,8791,4482,10303,1038,4309,11341,15480,616642,-170,16700
"Charleston-North Charleston-Summerville SC",2007,9409,4808,8748,457,4601,9205,13792,630434,-14,16700
"Charleston-North Charleston-Summerville SC",2008,9357,4924,8977,673,4433,9650,14072,644506,-11,16700
"Charlotte-Gastonia-Concord NC-SC",2000,5366,2305,4988,1693,3061,6681,9758,1340283,16,16740
"Charlotte-Gastonia-Concord NC-SC",2001,21762,10068,17355,6531,11694,23886,34606,1374889,-974,16740
"Charlotte-Gastonia-Concord NC-SC",2002,21972,10230,14067,6141,11742,20208,30982,1405871,-968,16740
"Charlotte-Gastonia-Concord NC-SC",2003,22350,10448,13749,5359,11902,19108,30039,1435910,-971,16740
"Charlotte-Gastonia-Concord NC-SC",2004,22674,10599,18992,4915,12075,23907,34432,1470342,-1550,16740
"Charlotte-Gastonia-Concord NC-SC",2005,23545,10589,31342,5152,12956,36494,48146,1518488,-1304,16740
"Charlotte-Gastonia-Concord NC-SC",2006,24806,10772,43295,5172,14034,48467,61582,1580070,-919,16740
"Charlotte-Gastonia-Concord NC-SC",2007,26283,10780,45549,4716,15503,50265,66361,1646431,593,16740
"Charlotte-Gastonia-Concord NC-SC",2008,27108,11164,34387,4734,15944,39121,55368,1701799,303,16740
"Charlottesville VA",2000,535,315,371,142,220,513,731,174752,-2,16820
"Charlottesville VA",2001,2211,1384,982,579,827,1561,3084,177836,696,16820
"Charlottesville VA",2002,2108,1336,828,536,772,1364,2691,180527,555,16820
"Charlottesville VA",2003,2208,1349,30,440,859,470,1913,182440,584,16820
"Charlottesville VA",2004,2291,1379,432,452,912,884,2251,184691,455,16820
"Charlottesville VA",2005,2171,1399,1860,457,772,2317,2964,187655,-125,16820
"Charlottesville VA",2006,2386,1411,1173,467,975,1640,2536,190191,-79,16820
"Charlottesville VA",2007,2390,1372,529,415,1018,944,1963,192154,1,16820
"Charlottesville VA",2008,2437,1468,832,416,969,1248,2237,194391,20,16820
"Chattanooga TN-GA",2000,1475,1148,189,144,327,333,683,477195,23,16860
"Chattanooga TN-GA",2001,6248,4940,1204,581,1308,1785,5443,482638,2350,16860
"Chattanooga TN-GA",2002,6082,4881,1305,546,1201,1851,4897,487535,1845,16860
"Chattanooga TN-GA",2003,6024,4822,1074,450,1202,1524,4524,492059,1798,16860
"Chattanooga TN-GA",2004,6266,4965,1000,448,1301,1448,4758,496817,2009,16860
"Chattanooga TN-GA",2005,6007,5050,2094,468,957,2562,5478,502295,1959,16860
"Chattanooga TN-GA",2006,6141,4885,3048,477,1256,3525,6901,509196,2120,16860
"Chattanooga TN-GA",2007,6644,5134,2974,420,1510,3394,5013,514209,109,16860
"Chattanooga TN-GA",2008,6687,5218,2125,427,1469,2552,4232,518441,211,16860
"Cheyenne WY",2000,275,157,-45,62,118,17,141,81748,6,16940
"Cheyenne WY",2001,1154,667,200,27,487,227,632,82380,-82,16940
"Cheyenne WY",2002,1150,681,485,-134,469,351,755,83135,-65,16940
"Cheyenne WY",2003,1192,638,1088,-450,554,638,1154,84289,-38,16940
"Cheyenne WY",2004,1261,703,173,250,558,423,921,85210,-60,16940
"Cheyenne WY",2005,1271,707,-409,14,564,-395,94,85304,-75,16940
"Cheyenne WY",2006,1330,691,-154,144,639,-10,586,85890,-43,16940
"Cheyenne WY",2007,1334,718,-13,-3,616,-16,590,86480,-10,16940
"Cheyenne WY",2008,1339,694,377,54,645,431,1062,87542,-14,16940
"Chicago-Naperville-Joliet IL-IN-WI",2000,35802,17019,-14183,15044,18783,861,19366,9117995,-278,16980
"Chicago-Naperville-Joliet IL-IN-WI",2001,144287,71429,-55164,58856,72858,3692,77366,9195361,816,16980
"Chicago-Naperville-Joliet IL-IN-WI",2002,141220,70804,-68856,54871,70416,-13985,56772,9252133,341,16980
"Chicago-Naperville-Joliet IL-IN-WI",2003,140929,70055,-72424,46195,70874,-26229,46868,9299001,2223,16980
"Chicago-Naperville-Joliet IL-IN-WI",2004,142929,69459,-65555,45673,73470,-19882,52946,9351947,-642,16980
"Chicago-Naperville-Joliet IL-IN-WI",2005,138742,68894,-77736,46934,69848,-30802,38744,9390691,-302,16980
"Chicago-Naperville-Joliet IL-IN-WI",2006,138253,67769,-69542,47735,70484,-21807,49114,9439805,437,16980
"Chicago-Naperville-Joliet IL-IN-WI",2007,140173,68233,-55355,42647,71940,-12708,57048,9496853,-2184,16980
"Chicago-Naperville-Joliet IL-IN-WI",2008,143040,68723,-42110,43047,74317,937,72771,9569624,-2483,16980
"Chico CA",2000,554,523,577,130,31,707,736,203907,-2,17020
"Chico CA",2001,2277,2219,2087,479,58,2566,2459,206366,-165,17020
"Chico CA",2002,2277,2286,2618,435,-9,3053,2933,209299,-111,17020
"Chico CA",2003,2322,2178,1958,361,144,2319,2285,211584,-178,17020
"Chico CA",2004,2401,2164,1177,367,237,1544,1609,213193,-172,17020
"Chico CA",2005,2363,2195,1330,374,168,1704,1680,214873,-192,17020
"Chico CA",2006,2571,2297,1711,384,274,2095,2258,217131,-111,17020
"Chico CA",2007,2668,2182,233,349,486,582,1054,218185,-14,17020
"Chico CA",2008,2752,2134,1126,355,618,1481,2152,220337,53,17020
"Cincinnati-Middletown OH-KY-IN",2000,7587,3978,679,698,3609,1377,4961,2014615,-25,17140
"Cincinnati-Middletown OH-KY-IN",2001,29517,17599,-1560,2661,11918,1101,20779,2035394,7760,17140
"Cincinnati-Middletown OH-KY-IN",2002,28391,17925,-4901,2490,10466,-2411,14235,2049629,6180,17140
"Cincinnati-Middletown OH-KY-IN",2003,28808,17540,-3657,2125,11268,-1532,15902,2065531,6166,17140
"Cincinnati-Middletown OH-KY-IN",2004,29568,17711,-2075,2014,11857,-61,17265,2082796,5469,17140
"Cincinnati-Middletown OH-KY-IN",2005,29431,17852,-1837,2085,11579,248,18419,2101215,6592,17140
"Cincinnati-Middletown OH-KY-IN",2006,29706,17573,-680,2124,12133,1444,18744,2119959,5167,17140
"Cincinnati-Middletown OH-KY-IN",2007,30651,18140,-1354,1891,12511,537,23865,2143824,10817,17140
"Cincinnati-Middletown OH-KY-IN",2008,30886,18130,-3569,1897,12756,-1672,11313,2155137,229,17140
"Clarksville TN-KY",2000,1027,419,-287,343,608,56,669,232714,5,17300
"Clarksville TN-KY",2001,4369,1756,-1043,0,2613,-1043,2936,235650,1366,17300
"Clarksville TN-KY",2002,4153,1726,33,-1107,2427,-1074,2423,238073,1070,17300
"Clarksville TN-KY",2003,4125,1712,3022,-3337,2413,-315,3293,241366,1195,17300
"Clarksville TN-KY",2004,3767,1819,-1290,1588,1948,298,3290,244656,1044,17300
"Clarksville TN-KY",2005,4765,1810,4877,-111,2955,4766,6904,251560,-817,17300
"Clarksville TN-KY",2006,4634,1831,-5715,823,2803,-4892,894,252454,2983,17300
"Clarksville TN-KY",2007,4257,1956,7135,-173,2301,6962,9395,261849,132,17300
"Clarksville TN-KY",2008,4783,1923,-3799,235,2860,-3564,-629,261220,75,17300
"Cleveland TN",2000,341,220,145,27,121,172,297,104300,4,17420
"Cleveland TN",2001,1344,966,356,123,378,479,761,105061,-96,17420
"Cleveland TN",2002,1404,974,19,118,430,137,478,105539,-89,17420
"Cleveland TN",2003,1371,1024,177,100,347,277,478,106017,-146,17420
"Cleveland TN",2004,1437,1030,465,91,407,556,872,106889,-91,17420
"Cleveland TN",2005,1344,1050,758,97,294,855,1051,107940,-98,17420
"Cleveland TN",2006,1411,1091,1021,98,320,1119,1385,109325,-54,17420
"Cleveland TN",2007,1433,1064,1090,88,369,1178,1585,110910,38,17420
"Cleveland TN",2008,1459,1068,726,89,391,815,1233,112143,27,17420
"Cleveland-Elyria-Mentor OH",2000,7285,5012,-3257,908,2273,-2349,-73,2147944,3,17460
"Cleveland-Elyria-Mentor OH",2001,28287,21668,-14943,3767,6619,-11176,-3964,2143980,593,17460
"Cleveland-Elyria-Mentor OH",2002,26967,21691,-13586,3514,5276,-10072,-4430,2139550,366,17460
"Cleveland-Elyria-Mentor OH",2003,26724,21296,-13684,3037,5428,-10647,-4861,2134689,358,17460
"Cleveland-Elyria-Mentor OH",2004,26728,21701,-14597,2898,5027,-11699,-7356,2127333,-684,17460
"Cleveland-Elyria-Mentor OH",2005,25816,21591,-17697,2995,4225,-14702,-11029,2116304,-552,17460
"Cleveland-Elyria-Mentor OH",2006,25968,20604,-20487,3334,5364,-17153,-12454,2103850,-665,17460
"Cleveland-Elyria-Mentor OH",2007,25897,20904,-16829,2940,4993,-13889,-8965,2094885,-69,17460
"Cleveland-Elyria-Mentor OH",2008,26064,20647,-14896,2947,5417,-11949,-6594,2088291,-62,17460
"Coeur d'Alene ID",2000,407,221,687,8,186,695,858,109543,-23,17660
"Coeur d'Alene ID",2001,1532,849,1541,52,683,1593,2176,111719,-100,17660
"Coeur d'Alene ID",2002,1463,905,1793,46,558,1839,2306,114025,-91,17660
"Coeur d'Alene ID",2003,1515,873,2287,29,642,2316,2927,116952,-31,17660
"Coeur d'Alene ID",2004,1569,946,4201,46,623,4247,4669,121621,-201,17660
"Coeur d'Alene ID",2005,1580,1023,4595,39,557,4634,5121,126742,-70,17660
"Coeur d'Alene ID",2006,1592,933,3168,42,659,3210,3788,130530,-81,17660
"Coeur d'Alene ID",2007,1766,1014,2984,35,752,3019,3681,134211,-90,17660
"Coeur d'Alene ID",2008,1778,1070,2670,38,708,2708,3264,137475,-152,17660
"College Station-Bryan TX",2000,667,257,-173,320,410,147,565,185450,8,17780
"College Station-Bryan TX",2001,2690,1133,-1254,1237,1557,-17,1372,186822,-168,17780
"College Station-Bryan TX",2002,2655,1108,-55,1150,1547,1095,2455,189277,-187,17780
"College Station-Bryan TX",2003,2737,1136,381,975,1601,1356,2693,191970,-264,17780
"College Station-Bryan TX",2004,2786,1152,-685,949,1634,264,1747,193717,-151,17780
"College Station-Bryan TX",2005,2897,1148,84,974,1749,1058,2638,196355,-169,17780
"College Station-Bryan TX",2006,2889,1181,1112,978,1708,2090,3692,200047,-106,17780
"College Station-Bryan TX",2007,3041,1144,390,883,1897,1273,3152,203199,-18,17780
"College Station-Bryan TX",2008,3155,1187,1387,889,1968,2276,4226,207425,-18,17780
"Colorado Springs CO",2000,2157,770,527,636,1387,1163,2596,540084,46,17820
"Colorado Springs CO",2001,8569,3106,8948,1117,5463,10065,16530,556614,1002,17820
"Colorado Springs CO",2002,8963,3232,3234,-101,5731,3133,9529,566143,665,17820
"Colorado Springs CO",2003,8675,3313,2801,-2332,5362,469,6388,572531,557,17820
"Colorado Springs CO",2004,8463,3476,-777,2379,4987,1602,7509,580040,920,17820
"Colorado Springs CO",2005,8769,3354,2613,693,5415,3306,8678,588718,-43,17820
"Colorado Springs CO",2006,8849,3560,5816,1618,5289,7434,12719,601437,-4,17820
"Colorado Springs CO",2007,9399,3374,-231,600,6025,369,6421,607858,27,17820
"Colorado Springs CO",2008,9361,3572,2874,986,5789,3860,9856,617714,207,17820
"Columbia MO",2000,464,215,-25,116,249,91,353,146019,13,17860
"Columbia MO",2001,1883,955,524,453,928,977,1761,147780,-144,17860
"Columbia MO",2002,1873,986,734,423,887,1157,1928,149708,-116,17860
"Columbia MO",2003,1930,976,577,356,954,933,1705,151413,-182,17860
"Columbia MO",2004,2027,1001,513,339,1026,852,1764,153177,-114,17860
"Columbia MO",2005,2119,950,1517,353,1169,1870,2903,156080,-136,17860
"Columbia MO",2006,2084,962,1941,356,1122,2297,3335,159415,-84,17860
"Columbia MO",2007,2221,984,944,324,1237,1268,2501,161916,-4,17860
"Columbia MO",2008,2317,988,674,326,1329,1000,2367,164283,38,17860
"Columbia SC",2000,2081,1295,606,464,786,1070,1899,649147,43,17900
"Columbia SC",2001,9043,5427,4238,1030,3616,5268,8291,657438,-593,17900
"Columbia SC",2002,8870,5413,2279,516,3457,2795,5666,663104,-586,17900
"Columbia SC",2003,8913,5487,7245,-749,3426,6496,9519,672623,-403,17900
"Columbia SC",2004,9135,5603,7172,1591,3532,8763,11616,684239,-679,17900
"Columbia SC",2005,9249,5574,2509,892,3675,3401,6478,690717,-598,17900
"Columbia SC",2006,9725,5614,7198,1256,4111,8454,12197,702914,-368,17900
"Columbia SC",2007,9837,5793,8004,672,4044,8676,12764,715678,44,17900
"Columbia SC",2008,9739,5944,7563,883,3795,8446,12385,728063,144,17900
"Columbus GA-AL",2000,1088,605,-407,295,483,-112,378,282114,7,17980
"Columbus GA-AL",2001,4364,2704,-480,302,1660,-178,1277,283391,-205,17980
"Columbus GA-AL",2002,4171,2715,1952,-465,1456,1487,2832,286223,-111,17980
"Columbus GA-AL",2003,4151,2677,-3928,-2174,1474,-6102,-4674,281549,-46,17980
"Columbus GA-AL",2004,4320,2700,2267,1378,1620,3645,4964,286513,-301,17980
"Columbus GA-AL",2005,4384,2627,-203,170,1757,-33,1478,287991,-246,17980
"Columbus GA-AL",2006,4314,2742,-292,830,1572,538,1976,289967,-134,17980
"Columbus GA-AL",2007,4593,2743,-5192,87,1850,-5105,-3078,286889,177,17980
"Columbus GA-AL",2008,4494,2733,-1455,377,1761,-1078,764,287653,81,17980
"Columbus IN",2000,247,157,142,52,90,194,288,71723,4,18020
"Columbus IN",2001,1006,612,-319,237,394,-82,250,71973,-62,18020
"Columbus IN",2002,991,636,-854,223,355,-631,-320,71653,-44,18020
"Columbus IN",2003,992,603,-215,188,389,-27,273,71926,-89,18020
"Columbus IN",2004,1043,691,6,187,352,193,494,72420,-51,18020
"Columbus IN",2005,1077,731,172,191,346,363,649,73069,-60,18020
"Columbus IN",2006,1092,641,215,194,451,409,820,73889,-40,18020
"Columbus IN",2007,1053,653,120,177,400,297,689,74578,-8,18020
"Columbus IN",2008,1079,683,191,177,396,368,782,75360,18,18020
"Columbus OH",2000,6259,2923,2123,1124,3336,3247,6661,1619505,78,18140
"Columbus OH",2001,25127,12618,5670,4649,12509,10319,22356,1641861,-472,18140
"Columbus OH",2002,24831,12510,430,4323,12321,4753,16806,1658667,-268,18140
"Columbus OH",2003,25067,12665,3333,3732,12402,7065,19124,1677791,-343,18140
"Columbus OH",2004,25612,12990,2288,3515,12622,5803,16938,1694729,-1487,18140
"Columbus OH",2005,25741,13169,2672,3647,12572,6319,17519,1712248,-1372,18140
"Columbus OH",2006,26400,12592,3473,3709,13808,7182,20230,1732478,-760,18140
"Columbus OH",2007,27157,13117,3222,3340,14040,6562,20532,1753010,-70,18140
"Columbus OH",2008,27219,13008,2499,3347,14211,5846,20110,1773120,53,18140
"Corpus Christi TX",2000,1617,764,-1176,222,853,-954,-93,403189,8,18580
"Corpus Christi TX",2001,6687,3352,-5474,531,3335,-4943,-1881,401308,-273,18580
"Corpus Christi TX",2002,6545,3251,-1554,219,3294,-1335,1618,402926,-341,18580
"Corpus Christi TX",2003,6224,3290,-1385,-458,2934,-1843,653,403579,-438,18580
"Corpus Christi TX",2004,6401,3307,-214,842,3094,628,3442,407021,-280,18580
"Corpus Christi TX",2005,6593,3269,126,407,3324,533,3488,410509,-369,18580
"Corpus Christi TX",2006,6390,3145,-1528,634,3245,-894,2152,412661,-199,18580
"Corpus Christi TX",2007,6478,3355,-3099,342,3123,-2757,393,413054,27,18580
"Corpus Christi TX",2008,6661,3376,-1472,464,3285,-1008,2322,415376,45,18580
"Corvallis OR",2000,188,119,-120,100,69,-20,48,78187,-1,18700
"Corvallis OR",2001,779,463,-664,372,316,-292,-38,78149,-62,18700
"Corvallis OR",2002,796,434,787,344,362,1131,1436,79585,-57,18700
"Corvallis OR",2003,771,519,-669,294,252,-375,-187,79398,-64,18700
"Corvallis OR",2004,752,496,-908,284,256,-624,-449,78949,-81,18700
"Corvallis OR",2005,804,485,-43,292,319,249,503,79452,-65,18700
"Corvallis OR",2006,791,488,99,297,303,396,658,80110,-41,18700
"Corvallis OR",2007,804,525,525,269,279,794,1041,81151,-32,18700
"Corvallis OR",2008,863,510,97,270,353,367,708,81859,-12,18700
"Cumberland MD-WV",2000,292,296,-166,4,-4,-162,-163,101845,3,19060
"Cumberland MD-WV",2001,1078,1196,-339,21,-118,-318,-529,101316,-93,19060
"Cumberland MD-WV",2002,976,1251,-126,19,-275,-107,-464,100852,-82,19060
"Cumberland MD-WV",2003,1008,1155,-104,8,-147,-96,-369,100483,-126,19060
"Cumberland MD-WV",2004,941,1260,252,16,-319,268,-129,100354,-78,19060
"Cumberland MD-WV",2005,961,1290,-405,13,-329,-392,-808,99546,-87,19060
"Cumberland MD-WV",2006,977,1224,-171,16,-247,-155,-449,99097,-47,19060
"Cumberland MD-WV",2007,985,1158,391,12,-173,403,205,99302,-25,19060
"Cumberland MD-WV",2008,1016,1154,-103,11,-138,-92,-269,99033,-39,19060
"Dallas-Fort Worth-Arlington TX",2000,21800,7462,9198,11314,14338,20512,34729,5196259,-121,19100
"Dallas-Fort Worth-Arlington TX",2001,94226,32576,48552,44845,61650,93397,158487,5354746,3440,19100
"Dallas-Fort Worth-Arlington TX",2002,95695,33129,13919,42217,62566,56136,122233,5476979,3531,19100
"Dallas-Fort Worth-Arlington TX",2003,97379,32202,-1303,36784,65177,35481,105720,5582699,5062,19100
"Dallas-Fort Worth-Arlington TX",2004,98193,32825,8504,33813,65368,42317,108325,5691024,640,19100
"Dallas-Fort Worth-Arlington TX",2005,99029,33361,23455,35473,65668,58928,126672,5817696,2076,19100
"Dallas-Fort Worth-Arlington TX",2006,101274,32995,71433,35458,68279,106891,177900,5995596,2730,19100
"Dallas-Fort Worth-Arlington TX",2007,103652,34592,52260,32194,69060,84454,157878,6153474,4364,19100
"Dallas-Fort Worth-Arlington TX",2008,106131,35279,43175,32293,70852,75468,146532,6300006,212,19100
"Dalton GA",2000,563,221,182,270,342,452,800,120861,6,19140
"Dalton GA",2001,2300,952,126,1046,1348,1172,2423,123284,-97,19140
"Dalton GA",2002,2433,909,-912,983,1524,71,1504,124788,-91,19140
"Dalton GA",2003,2356,1021,-648,870,1335,222,1469,126257,-88,19140
"Dalton GA",2004,2415,992,-6,776,1423,770,2097,128354,-96,19140
"Dalton GA",2005,2552,1043,-439,825,1509,386,1778,130132,-117,19140
"Dalton GA",2006,2522,996,-504,824,1526,320,1777,131909,-69,19140
"Dalton GA",2007,2478,1007,-936,756,1471,-180,1258,133167,-33,19140
"Dalton GA",2008,2487,984,-1227,759,1503,-468,972,134139,-63,19140
"Danville IL",2000,292,225,-198,8,67,-190,-125,83799,-2,19180
"Danville IL",2001,1178,934,-576,52,244,-524,-347,83452,-67,19180
"Danville IL",2002,1092,958,-655,51,134,-604,-529,82923,-59,19180
"Danville IL",2003,1081,966,-612,39,115,-573,-537,82386,-79,19180
"Danville IL",2004,1112,1005,-305,43,107,-262,-216,82170,-61,19180
"Danville IL",2005,1080,967,-507,43,113,-464,-427,81743,-76,19180
"Danville IL",2006,1151,959,-300,43,192,-257,-102,81641,-37,19180
"Danville IL",2007,1121,910,-742,37,211,-705,-474,81167,20,19180
"Danville IL",2008,1095,963,-694,39,132,-655,-487,80680,36,19180
"Danville VA",2000,314,297,-185,15,17,-170,-157,109999,-4,19260
"Danville VA",2001,1322,1366,-586,90,-44,-496,-648,109351,-108,19260
"Danville VA",2002,1282,1432,-566,82,-150,-484,-733,108618,-99,19260
"Danville VA",2003,1239,1345,-344,67,-106,-277,-524,108094,-141,19260
"Danville VA",2004,1261,1300,-708,76,-39,-632,-764,107330,-93,19260
"Danville VA",2005,1226,1307,-617,76,-81,-541,-712,106618,-90,19260
"Danville VA",2006,1207,1382,-350,80,-175,-270,-494,106124,-49,19260
"Danville VA",2007,1338,1376,-185,66,-38,-119,-176,105948,-19,19260
"Danville VA",2008,1273,1357,-112,66,-84,-46,-165,105783,-35,19260
"Davenport-Moline-Rock Island IA-IL",2000,1229,847,-767,121,382,-646,-257,375795,7,19340
"Davenport-Moline-Rock Island IA-IL",2001,5010,3533,-2923,549,1477,-2374,-1208,374587,-311,19340
"Davenport-Moline-Rock Island IA-IL",2002,4931,3474,-2478,522,1457,-1956,-783,373804,-284,19340
"Davenport-Moline-Rock Island IA-IL",2003,4952,3612,-2403,438,1340,-1965,-957,372847,-332,19340
"Davenport-Moline-Rock Island IA-IL",2004,4897,3405,-1840,454,1492,-1386,-42,372805,-148,19340
"Davenport-Moline-Rock Island IA-IL",2005,4990,3429,-1542,456,1561,-1086,256,373061,-219,19340
"Davenport-Moline-Rock Island IA-IL",2006,5020,3422,-1103,463,1598,-640,865,373926,-93,19340
"Davenport-Moline-Rock Island IA-IL",2007,4996,3384,-368,420,1612,52,1712,375638,48,19340
"Davenport-Moline-Rock Island IA-IL",2008,5195,3397,-422,426,1798,4,1988,377626,186,19340
"Dayton OH",2000,2869,1812,-1401,226,1057,-1175,-99,848056,19,19380
"Dayton OH",2001,11242,8148,-5861,699,3094,-5162,-2051,846005,17,19380
"Dayton OH",2002,10890,8145,-3779,380,2745,-3399,-735,845270,-81,19380
"Dayton OH",2003,10788,7979,-2296,-113,2809,-2409,50,845320,-350,19380
"Dayton OH",2004,10848,8101,-3613,818,2747,-2795,-86,845234,-38,19380
"Dayton OH",2005,10616,8019,-5098,447,2597,-4651,-2155,843079,-101,19380
"Dayton OH",2006,10643,7723,-5930,694,2920,-5236,-2097,840982,219,19380
"Dayton OH",2007,10983,8042,-6117,441,2941,-5676,-2154,838828,581,19380
"Dayton OH",2008,10973,8018,-5817,484,2955,-5333,-2284,836544,94,19380
"Decatur AL",2000,466,318,-38,49,148,11,167,146040,8,19460
"Decatur AL",2001,1979,1398,-416,202,581,-214,231,146271,-136,19460
"Decatur AL",2002,1836,1408,-839,190,428,-649,-339,145932,-118,19460
"Decatur AL",2003,1899,1345,53,155,554,208,584,146516,-178,19460
"Decatur AL",2004,1896,1438,-817,156,458,-661,-320,146196,-117,19460
"Decatur AL",2005,1899,1408,240,155,491,395,753,146949,-133,19460
"Decatur AL",2006,1909,1475,313,162,434,475,837,147786,-72,19460
"Decatur AL",2007,1938,1543,686,150,395,836,1209,148995,-22,19460
"Decatur AL",2008,1979,1482,436,149,497,585,1130,150125,48,19460
"Decatur IL",2000,354,273,-311,10,81,-301,-225,114481,-5,19500
"Decatur IL",2001,1466,1154,-1445,53,312,-1392,-1163,113318,-83,19500
"Decatur IL",2002,1411,1129,-1593,48,282,-1545,-1320,111998,-57,19500
"Decatur IL",2003,1465,1197,-1559,28,268,-1531,-1315,110683,-52,19500
"Decatur IL",2004,1349,1245,-719,49,104,-670,-656,110027,-90,19500
"Decatur IL",2005,1374,1213,-496,45,161,-451,-392,109635,-102,19500
"Decatur IL",2006,1422,1168,-805,46,254,-759,-553,109082,-48,19500
"Decatur IL",2007,1428,1196,-722,40,232,-682,-418,108664,32,19500
"Decatur IL",2008,1429,1163,-679,43,266,-636,-336,108328,34,19500
"Deltona-Daytona Beach-Ormond Beach FL",2000,1024,1309,1732,234,-285,1966,1671,445012,-10,19660
"Deltona-Daytona Beach-Ormond Beach FL",2001,4615,5819,6753,851,-1204,7604,6155,451167,-245,19660
"Deltona-Daytona Beach-Ormond Beach FL",2002,4551,5907,7841,789,-1356,8630,7075,458242,-199,19660
"Deltona-Daytona Beach-Ormond Beach FL",2003,4671,6024,8263,672,-1353,8935,7576,465818,-6,19660
"Deltona-Daytona Beach-Ormond Beach FL",2004,4882,6033,11878,655,-1151,12533,10693,476511,-689,19660
"Deltona-Daytona Beach-Ormond Beach FL",2005,4901,6265,10376,676,-1364,11052,9205,485716,-483,19660
"Deltona-Daytona Beach-Ormond Beach FL",2006,5153,6150,9771,776,-997,10547,9305,495021,-245,19660
"Deltona-Daytona Beach-Ormond Beach FL",2007,5351,6163,4553,685,-812,5238,4713,499734,287,19660
"Deltona-Daytona Beach-Ormond Beach FL",2008,5519,6221,-2127,689,-702,-1438,-1698,498036,442,19660
"Denver-Aurora CO",2000,8805,3161,5176,3752,5644,8928,14544,2193882,-28,19740
"Denver-Aurora CO",2001,36107,13444,16883,14280,22663,31163,53094,2246976,-732,19740
"Denver-Aurora CO",2002,36289,13943,-5212,13341,22346,8129,30097,2277073,-378,19740
"Denver-Aurora CO",2003,37333,13845,-12539,11551,23488,-988,22236,2299309,-264,19740
"Denver-Aurora CO",2004,37184,13888,-7127,10854,23296,3727,25533,2324842,-1490,19740
"Denver-Aurora CO",2005,37683,14040,-429,11299,23643,10870,33429,2358271,-1084,19740
"Denver-Aurora CO",2006,37477,14002,10161,11326,23475,21487,44842,2403113,-120,19740
"Denver-Aurora CO",2007,38314,13799,15772,10243,24515,26015,50280,2453393,-250,19740
"Denver-Aurora CO",2008,39364,14387,17872,10296,24977,28168,53233,2506626,88,19740
"Des Moines-West Des Moines IA",2000,1832,845,348,413,987,761,1779,483173,31,19780
"Des Moines-West Des Moines IA",2001,7601,3640,1219,1535,3961,2754,6999,490172,284,19780
"Des Moines-West Des Moines IA",2002,7461,3818,1610,1431,3643,3041,6872,497044,188,19780
"Des Moines-West Des Moines IA",2003,7694,3724,2001,1227,3970,3228,7320,504364,122,19780
"Des Moines-West Des Moines IA",2004,7772,3859,3000,1170,3913,4170,7736,512100,-347,19780
"Des Moines-West Des Moines IA",2005,8097,3719,4983,1201,4378,6184,11504,523604,942,19780
"Des Moines-West Des Moines IA",2006,8431,3760,5197,1218,4671,6415,11055,534659,-31,19780
"Des Moines-West Des Moines IA",2007,8786,3745,4840,1088,5041,5928,11010,545669,41,19780
"Des Moines-West Des Moines IA",2008,8801,3877,4383,1089,4924,5472,10561,556230,165,19780
"Detroit-Warren-Livonia MI",2000,16029,9313,-5141,3347,6716,-1794,4949,4457507,27,19820
"Detroit-Warren-Livonia MI",2001,62537,39820,-25209,14021,22717,-11188,20308,4477815,8779,19820
"Detroit-Warren-Livonia MI",2002,60501,39376,-33974,13125,21125,-20849,7138,4484953,6862,19820
"Detroit-Warren-Livonia MI",2003,59672,39300,-30532,11449,20372,-19083,7510,4492463,6221,19820
"Detroit-Warren-Livonia MI",2004,59554,38617,-31013,10521,20937,-20492,6628,4499091,6183,19820
"Detroit-Warren-Livonia MI",2005,57886,38738,-38727,11029,19148,-27698,-2611,4496480,5939,19820
"Detroit-Warren-Livonia MI",2006,56767,37811,-46477,11124,18956,-35353,-9860,4486620,6537,19820
"Detroit-Warren-Livonia MI",2007,56972,37645,-59081,10054,19327,-49027,-29097,4457523,603,19820
"Detroit-Warren-Livonia MI",2008,56901,37617,-62160,10071,19284,-52089,-32413,4425110,392,19820
"Dothan AL",2000,441,355,91,17,86,108,198,131057,4,20020
"Dothan AL",2001,1886,1391,-248,74,495,-174,199,131256,-122,20020
"Dothan AL",2002,1695,1408,140,64,287,204,354,131610,-137,20020
"Dothan AL",2003,1791,1345,991,34,446,1025,1348,132958,-123,20020
"Dothan AL",2004,1856,1431,870,67,425,937,1249,134207,-113,20020
"Dothan AL",2005,1718,1468,1142,55,250,1197,1339,135546,-108,20020
"Dothan AL",2006,1850,1473,1545,63,377,1608,1912,137458,-73,20020
"Dothan AL",2007,1852,1479,1488,48,373,1536,1878,139336,-31,20020
"Dothan AL",2008,1896,1427,1128,48,469,1176,1625,140961,-20,20020
"Dover DE",2000,460,242,110,74,218,184,408,127110,6,20100
"Dover DE",2001,1939,1063,816,134,876,950,1702,128812,-124,20100
"Dover DE",2002,1859,1087,1815,-42,772,1773,2462,131274,-83,20100
"Dover DE",2003,1989,1152,2471,-386,837,2085,2899,134173,-23,20100
"Dover DE",2004,2023,1127,3099,326,896,3425,4146,138319,-175,20100
"Dover DE",2005,2085,1184,4016,69,901,4085,4887,143206,-99,20100
"Dover DE",2006,2234,1241,3190,219,993,3409,4314,147520,-88,20100
"Dover DE",2007,2261,1185,3084,74,1076,3158,4185,151705,-49,20100
"Dover DE",2008,2358,1213,2509,125,1145,2634,3710,155415,-69,20100
"Dubuque IA",2000,322,202,-76,25,120,-51,75,89231,6,20220
"Dubuque IA",2001,1195,846,-711,113,349,-598,-243,88988,6,20220
"Dubuque IA",2002,1131,829,-181,106,302,-75,217,89205,-10,20220
"Dubuque IA",2003,1240,794,405,85,446,490,904,90109,-32,20220
"Dubuque IA",2004,1177,795,20,91,382,111,524,90633,31,20220
"Dubuque IA",2005,1207,854,-100,89,353,-11,342,90975,0,20220
"Dubuque IA",2006,1133,879,77,93,254,170,423,91398,-1,20220
"Dubuque IA",2007,1253,843,383,86,410,469,898,92296,19,20220
"Dubuque IA",2008,1256,799,-174,86,457,-88,428,92724,59,20220
"Duluth MN-WI",2000,747,653,-28,25,94,-3,90,275575,-1,20260
"Duluth MN-WI",2001,2854,2962,1028,130,-108,1158,802,276377,-248,20260
"Duluth MN-WI",2002,2833,2948,-352,105,-115,-247,-601,275776,-239,20260
"Duluth MN-WI",2003,2911,3036,222,49,-125,271,-198,275578,-344,20260
"Duluth MN-WI",2004,3101,2943,-667,127,158,-540,-599,274979,-217,20260
"Duluth MN-WI",2005,2933,2855,-780,95,78,-685,-863,274116,-256,20260
"Duluth MN-WI",2006,3097,2781,-741,116,316,-625,-434,273682,-125,20260
"Duluth MN-WI",2007,3102,2903,-239,84,199,-155,75,273757,31,20260
"Duluth MN-WI",2008,3215,2795,241,86,420,327,814,274571,67,20260
"Durham NC",2000,1448,763,735,873,685,1608,2308,426104,15,20500
"Durham NC",2001,6346,3245,3075,3323,3101,6398,9126,435230,-373,20500
"Durham NC",2002,6365,3244,551,3136,3121,3687,6553,441783,-255,20500
"Durham NC",2003,6314,3266,-901,2741,3048,1840,4426,446209,-462,20500
"Durham NC",2004,6362,3294,-311,2526,3068,2215,4923,451132,-360,20500
"Durham NC",2005,6507,3308,1379,2649,3199,4028,6811,457943,-416,20500
"Durham NC",2006,6645,3240,3380,2654,3405,6034,9191,467134,-248,20500
"Durham NC",2007,6925,3290,4773,2409,3635,7182,10869,478003,52,20500
"Durham NC",2008,7015,3370,5588,2420,3645,8008,11759,489762,106,20500
"Eau Claire WI",2000,448,276,155,18,172,173,352,148689,7,20740
"Eau Claire WI",2001,1777,1237,522,81,540,603,1008,149697,-135,20740
"Eau Claire WI",2002,1828,1221,605,76,607,681,1156,150853,-132,20740
"Eau Claire WI",2003,1780,1262,453,61,518,514,860,151713,-172,20740
"Eau Claire WI",2004,1792,1168,1150,70,624,1220,1691,153404,-153,20740
"Eau Claire WI",2005,1904,1225,724,67,679,791,1334,154738,-136,20740
"Eau Claire WI",2006,1925,1181,538,71,744,609,1272,156010,-81,20740
"Eau Claire WI",2007,2034,1243,697,61,791,758,1539,157549,-10,20740
"Eau Claire WI",2008,2050,1223,261,61,827,322,1193,158742,44,20740
"El Centro CA",2000,562,205,-617,309,357,-308,50,142411,1,20940
"El Centro CA",2001,2583,875,-2018,1171,1708,-847,766,143177,-95,20940
"El Centro CA",2002,2584,893,-1229,1094,1691,-135,1452,144629,-104,20940
"El Centro CA",2003,2814,926,117,940,1888,1057,2730,147359,-215,20940
"El Centro CA",2004,2923,923,-98,916,2000,818,2719,150078,-99,20940
"El Centro CA",2005,3021,894,292,935,2127,1227,3207,153285,-147,20940
"El Centro CA",2006,2986,956,832,936,2030,1768,3714,156999,-84,20940
"El Centro CA",2007,3291,954,657,843,2337,1500,3831,160830,-6,20940
"El Centro CA",2008,3488,1002,-210,852,2486,642,3142,163972,14,20940
"El Paso TX",2000,3472,929,-2497,1349,2543,-1148,1404,681026,9,21340
"El Paso TX",2001,14220,4094,-10405,4703,10126,-5702,4009,685035,-415,21340
"El Paso TX",2002,14004,4179,-9250,4005,9825,-5245,4178,689213,-402,21340
"El Paso TX",2003,14119,4160,-5590,2513,9959,-3077,6163,695376,-719,21340
"El Paso TX",2004,14606,4345,-5799,4227,10261,-1572,8061,703437,-628,21340
"El Paso TX",2005,14401,4216,-6741,3724,10185,-3017,6555,709992,-613,21340
"El Paso TX",2006,14383,4528,-1091,4080,9855,2989,12466,722458,-378,21340
"El Paso TX",2007,14568,4378,-5906,3323,10190,-2583,7511,729969,-96,21340
"El Paso TX",2008,15224,4598,-1940,3512,10626,1572,12093,742062,-105,21340
"Elizabethtown KY",2000,394,207,-162,112,187,-50,140,107690,3,21060
"Elizabethtown KY",2001,1624,844,-361,72,780,-289,391,108081,-100,21060
"Elizabethtown KY",2002,1558,833,-27,-233,725,-260,360,108441,-105,21060
"Elizabethtown KY",2003,1680,813,223,-855,867,-632,104,108545,-131,21060
"Elizabethtown KY",2004,1595,837,-824,487,758,-337,319,108864,-102,21060
"Elizabethtown KY",2005,1721,844,544,26,877,570,1343,110207,-104,21060
"Elizabethtown KY",2006,1779,908,-702,274,871,-428,394,110601,-49,21060
"Elizabethtown KY",2007,1783,884,84,-1,899,83,991,111592,9,21060
"Elizabethtown KY",2008,1725,907,-289,109,818,-180,676,112268,38,21060
"Elkhart-Goshen IN",2000,827,345,-7,238,482,231,731,183522,18,21140
"Elkhart-Goshen IN",2001,3311,1375,-1193,925,1936,-268,1511,185033,-157,21140
"Elkhart-Goshen IN",2002,2996,1502,-2285,877,1494,-1408,-20,185013,-106,21140
"Elkhart-Goshen IN",2003,3088,1361,412,769,1727,1181,2642,187655,-266,21140
"Elkhart-Goshen IN",2004,3252,1451,-74,693,1801,619,2293,189948,-127,21140
"Elkhart-Goshen IN",2005,3339,1427,1026,729,1912,1755,3480,193428,-187,21140
"Elkhart-Goshen IN",2006,3542,1409,148,732,2133,880,2913,196341,-100,21140
"Elkhart-Goshen IN",2007,3490,1407,-1475,667,2083,-808,1298,197639,23,21140
"Elkhart-Goshen IN",2008,3411,1372,-1217,667,2039,-550,1498,199137,9,21140
"Elmira NY",2000,269,226,-48,7,43,-41,7,91077,5,21300
"Elmira NY",2001,1130,910,-598,45,220,-553,-406,90671,-73,21300
"Elmira NY",2002,1083,916,-399,43,167,-356,-263,90408,-74,21300
"Elmira NY",2003,1058,946,-646,34,112,-612,-586,89822,-86,21300
"Elmira NY",2004,1041,931,-508,35,110,-473,-436,89386,-73,21300
"Elmira NY",2005,1013,975,-1004,35,38,-969,-1005,88381,-74,21300
"Elmira NY",2006,967,950,-308,38,17,-270,-292,88089,-39,21300
"Elmira NY",2007,1082,881,-393,33,201,-360,-176,87913,-17,21300
"Elmira NY",2008,1081,909,-303,34,172,-269,-100,87813,-3,21300
"Erie PA",2000,857,607,-488,100,250,-388,-130,280715,8,21500
"Erie PA",2001,3476,2682,-1442,426,794,-1016,766,281481,988,21500
"Erie PA",2002,3307,2705,-1407,397,602,-1010,366,281847,774,21500
"Erie PA",2003,3359,2694,-1449,330,665,-1119,251,282098,705,21500
"Erie PA",2004,3310,2669,-3384,338,641,-3046,-2430,279668,-25,21500
"Erie PA",2005,3290,2781,-1702,339,509,-1363,-887,278781,-33,21500
"Erie PA",2006,3328,2693,-144,368,635,224,860,279641,1,21500
"Erie PA",2007,3369,2654,-1420,330,715,-1090,-348,279293,27,21500
"Erie PA",2008,3379,2649,-1251,331,730,-920,-118,279175,72,21500
"Eugene-Springfield OR",2000,955,654,-22,196,301,174,506,323485,31,21660
"Eugene-Springfield OR",2001,3653,2828,92,751,825,843,1337,324822,-331,21660
"Eugene-Springfield OR",2002,3590,3011,1615,699,579,2314,2580,327402,-313,21660
"Eugene-Springfield OR",2003,3576,2815,2102,610,761,2712,3102,330504,-371,21660
"Eugene-Springfield OR",2004,3644,3001,497,562,643,1059,1486,331990,-216,21660
"Eugene-Springfield OR",2005,3509,3026,2637,591,483,3228,3432,335422,-279,21660
"Eugene-Springfield OR",2006,3588,2999,3002,586,589,3588,4000,339422,-177,21660
"Eugene-Springfield OR",2007,3801,2904,1945,540,897,2485,3359,342781,-23,21660
"Eugene-Springfield OR",2008,3938,2921,2158,541,1017,2699,3779,346560,63,21660
"Evansville IN-KY",2000,1043,850,-69,42,193,-27,182,342998,16,21780
"Evansville IN-KY",2001,4495,3535,-885,226,960,-659,-26,342972,-327,21780
"Evansville IN-KY",2002,4293,3546,153,215,747,368,774,343746,-341,21780
"Evansville IN-KY",2003,4409,3412,820,174,997,994,1578,345324,-413,21780
"Evansville IN-KY",2004,4647,3546,481,175,1101,656,1514,346838,-243,21780
"Evansville IN-KY",2005,4552,3469,-65,182,1083,117,880,347718,-320,21780
"Evansville IN-KY",2006,4585,3498,-230,185,1087,-45,878,348596,-164,21780
"Evansville IN-KY",2007,4638,3448,-254,168,1190,-86,1127,349723,23,21780
"Evansville IN-KY",2008,4645,3439,-943,165,1206,-778,538,350261,110,21780
"Fairbanks AK",2000,360,85,-465,120,275,-345,-71,82769,-1,21820
"Fairbanks AK",2001,1547,350,81,42,1197,123,2524,85293,1204,21820
"Fairbanks AK",2002,1492,310,240,-308,1182,-68,2119,87412,1005,21820
"Fairbanks AK",2003,1578,329,606,-1002,1249,-396,1882,89294,1029,21820
"Fairbanks AK",2004,1566,345,190,541,1221,731,3120,92414,1168,21820
"Fairbanks AK",2005,1583,374,-204,8,1209,-196,2147,94561,1134,21820
"Fairbanks AK",2006,1525,346,-2269,286,1179,-1983,242,94803,1046,21820
"Fairbanks AK",2007,1702,335,1827,-27,1367,1800,3183,97986,16,21820
"Fairbanks AK",2008,1825,326,-1610,103,1499,-1507,-16,97970,-8,21820
"Fargo ND-MN",2000,522,270,40,99,252,139,409,174776,18,22020
"Fargo ND-MN",2001,2208,1168,227,376,1040,603,1473,176249,-170,22020
"Fargo ND-MN",2002,2219,1128,-69,350,1091,281,1196,177445,-176,22020
"Fargo ND-MN",2003,2328,1247,748,276,1081,1024,1896,179341,-209,22020
"Fargo ND-MN",2004,2600,1208,2766,298,1392,3064,4251,183592,-205,22020
"Fargo ND-MN",2005,2486,1098,583,294,1388,877,2088,185680,-177,22020
"Fargo ND-MN",2006,2745,1154,1470,301,1591,1771,3268,188948,-94,22020
"Fargo ND-MN",2007,2822,1213,1091,279,1609,1370,2982,191930,3,22020
"Fargo ND-MN",2008,2900,1192,1687,283,1708,1970,3755,195685,77,22020
"Farmington NM",2000,503,166,-144,38,337,-106,241,114042,10,22140
"Farmington NM",2001,1945,760,-119,134,1185,15,1086,115128,-114,22140
"Farmington NM",2002,1982,765,1842,127,1217,1969,3128,118256,-58,22140
"Farmington NM",2003,1948,824,403,108,1124,511,1486,119742,-149,22140
"Farmington NM",2004,1980,756,-169,101,1224,-68,1075,120817,-81,22140
"Farmington NM",2005,2052,775,-246,108,1277,-138,1026,121843,-113,22140
"Farmington NM",2006,2107,805,-1582,109,1302,-1473,-223,121620,-52,22140
"Farmington NM",2007,2116,865,-737,93,1251,-644,619,122239,12,22140
"Farmington NM",2008,2018,868,-991,95,1150,-896,261,122500,7,22140
"Fayetteville NC",2000,1476,530,-1510,824,946,-686,257,336865,-3,22180
"Fayetteville NC",2001,6240,2234,-2562,39,4006,-2523,1215,338080,-268,22180
"Fayetteville NC",2002,6009,2288,2586,-1820,3721,766,4229,342309,-258,22180
"Fayetteville NC",2003,6046,2273,6851,-6168,3773,683,4512,346821,56,22180
"Fayetteville NC",2004,5952,2387,-4070,3076,3565,-994,2176,348997,-395,22180
"Fayetteville NC",2005,6307,2264,-8157,221,4043,-7936,-4142,344855,-249,22180
"Fayetteville NC",2006,6072,2362,-1972,1625,3710,-347,3198,348053,-165,22180
"Fayetteville NC",2007,6701,2213,-1162,-258,4488,-1420,3029,351082,-39,22180
"Fayetteville NC",2008,6375,2325,335,702,4050,1037,5023,356105,-64,22180
"Fayetteville-Springdale-Rogers AR-MO",2000,1309,663,1479,384,646,1863,2489,349525,-20,22220
"Fayetteville-Springdale-Rogers AR-MO",2001,5517,2798,4575,1569,2719,6144,8854,358379,-9,22220
"Fayetteville-Springdale-Rogers AR-MO",2002,5798,2823,4694,1468,2975,6162,9147,367526,10,22220
"Fayetteville-Springdale-Rogers AR-MO",2003,6024,2833,6783,1273,3191,8056,11482,379008,235,22220
"Fayetteville-Springdale-Rogers AR-MO",2004,6293,2926,8841,1174,3367,10015,13161,392169,-221,22220
"Fayetteville-Springdale-Rogers AR-MO",2005,6675,2845,9989,1221,3830,11210,15625,407794,585,22220
"Fayetteville-Springdale-Rogers AR-MO",2006,7053,2861,9897,1225,4192,11122,14652,422446,-662,22220
"Fayetteville-Springdale-Rogers AR-MO",2007,7534,2887,6424,1111,4647,7535,12197,434643,15,22220
"Fayetteville-Springdale-Rogers AR-MO",2008,7580,2826,3518,1112,4754,4630,9333,443976,-51,22220
"Flagstaff AZ",2000,460,117,-16,54,343,38,385,116703,4,22380
"Flagstaff AZ",2001,1847,526,-357,220,1321,-137,1068,117771,-116,22380
"Flagstaff AZ",2002,1921,604,1121,210,1317,1331,2562,120333,-86,22380
"Flagstaff AZ",2003,1903,579,-179,174,1324,-5,1127,121460,-192,22380
"Flagstaff AZ",2004,1946,649,409,161,1297,570,1775,123235,-92,22380
"Flagstaff AZ",2005,2111,633,-121,172,1478,51,1418,124653,-111,22380
"Flagstaff AZ",2006,2029,647,-179,173,1382,-6,1313,125966,-63,22380
"Flagstaff AZ",2007,2131,577,-261,152,1554,-109,1384,127350,-61,22380
"Flagstaff AZ",2008,2174,648,-406,154,1526,-252,1208,128558,-66,22380
"Flint MI",2000,1669,942,-103,54,727,-49,715,436863,37,22420
"Flint MI",2001,6369,3928,-1241,184,2441,-1057,981,437844,-403,22420
"Flint MI",2002,6226,4027,-1113,175,2199,-938,841,438685,-420,22420
"Flint MI",2003,6260,3893,-1117,147,2367,-970,763,439448,-634,22420
"Flint MI",2004,6296,4013,-1769,134,2283,-1635,330,439778,-318,22420
"Flint MI",2005,6060,3918,-2562,139,2142,-2423,-665,439113,-384,22420
"Flint MI",2006,6001,4042,-3578,139,1959,-3439,-1668,437445,-188,22420
"Flint MI",2007,6105,3757,-5925,119,2348,-5806,-3418,434027,40,22420
"Flint MI",2008,6058,3813,-7581,119,2245,-7462,-5237,428790,-20,22420
"Florence SC",2000,678,444,-152,22,234,-130,111,193266,7,22500
"Florence SC",2001,2787,2084,-91,103,703,12,519,193785,-196,22500
"Florence SC",2002,2761,2020,252,93,741,345,898,194683,-188,22500
"Florence SC",2003,2772,1996,263,70,776,333,856,195539,-253,22500
"Florence SC",2004,2779,2073,-155,90,706,-65,496,196035,-145,22500
"Florence SC",2005,2775,2077,30,86,698,116,635,196670,-179,22500
"Florence SC",2006,2815,2077,197,89,738,286,931,197601,-93,22500
"Florence SC",2007,2797,2100,136,73,697,209,936,198537,30,22500
"Florence SC",2008,2831,2127,401,77,704,478,1294,199831,112,22500
"Florence-Muscle Shoals AL",2000,403,302,-48,15,101,-33,66,143010,-2,22520
"Florence-Muscle Shoals AL",2001,1633,1603,-744,60,30,-684,-786,142224,-132,22520
"Florence-Muscle Shoals AL",2002,1595,1505,-798,54,90,-744,-781,141443,-127,22520
"Florence-Muscle Shoals AL",2003,1557,1529,-77,40,28,-37,-207,141236,-198,22520
"Florence-Muscle Shoals AL",2004,1567,1514,359,53,53,412,360,141596,-105,22520
"Florence-Muscle Shoals AL",2005,1502,1605,380,51,-103,431,194,141790,-134,22520
"Florence-Muscle Shoals AL",2006,1581,1597,611,58,-16,669,585,142375,-68,22520
"Florence-Muscle Shoals AL",2007,1639,1598,510,46,41,556,632,143007,35,22520
"Florence-Muscle Shoals AL",2008,1630,1616,670,46,14,716,784,143791,54,22520
"Fond du Lac WI",2000,290,204,-37,30,86,-7,87,97383,8,22540
"Fond du Lac WI",2001,1135,902,108,110,233,218,346,97729,-105,22540
"Fond du Lac WI",2002,1105,921,-148,105,184,-43,52,97781,-89,22540
"Fond du Lac WI",2003,1140,854,-58,87,286,29,175,97956,-140,22540
"Fond du Lac WI",2004,1178,915,-19,89,263,70,267,98223,-66,22540
"Fond du Lac WI",2005,1144,942,-26,89,202,63,169,98392,-96,22540
"Fond du Lac WI",2006,1195,972,7,91,223,98,275,98667,-46,22540
"Fond du Lac WI",2007,1248,912,-51,83,336,32,376,99043,8,22540
"Fond du Lac WI",2008,1274,898,-103,83,376,-20,410,99453,54,22540
"Fort Collins-Loveland CO",2000,876,349,941,173,527,1114,1637,253131,-4,22660
"Fort Collins-Loveland CO",2001,3320,1526,5277,661,1794,5938,7586,260717,-146,22660
"Fort Collins-Loveland CO",2002,3293,1524,2717,618,1769,3335,4915,265632,-189,22660
"Fort Collins-Loveland CO",2003,3363,1534,1032,535,1829,1567,3035,268667,-361,22660
"Fort Collins-Loveland CO",2004,3509,1559,918,521,1950,1439,3204,271871,-185,22660
"Fort Collins-Loveland CO",2005,3329,1538,1593,533,1791,2126,3699,275570,-218,22660
"Fort Collins-Loveland CO",2006,3511,1538,3021,535,1973,3556,5374,280944,-155,22660
"Fort Collins-Loveland CO",2007,3596,1474,3223,487,2122,3710,5783,286727,-49,22660
"Fort Collins-Loveland CO",2008,3751,1640,3562,491,2111,4053,6098,292825,-66,22660
"Fort Smith AR-OK",2000,1038,666,100,159,372,259,637,273814,6,22900
"Fort Smith AR-OK",2001,4140,2781,-86,599,1359,513,1622,275436,-250,22900
"Fort Smith AR-OK",2002,4117,2742,-56,550,1375,494,1609,277045,-260,22900
"Fort Smith AR-OK",2003,4078,2791,-130,427,1287,297,1261,278306,-323,22900
"Fort Smith AR-OK",2004,4029,2780,226,467,1249,693,1714,280020,-228,22900
"Fort Smith AR-OK",2005,4124,2884,830,464,1240,1294,2271,282291,-263,22900
"Fort Smith AR-OK",2006,4208,2842,1906,479,1366,2385,3607,285898,-144,22900
"Fort Smith AR-OK",2007,4395,2669,869,414,1726,1283,3015,288913,6,22900
"Fort Smith AR-OK",2008,4404,2743,-89,420,1661,331,2064,290977,72,22900
"Fort Walton Beach-Crestview-Destin FL",2000,599,290,-62,199,309,137,461,170958,15,23020
"Fort Walton Beach-Crestview-Destin FL",2001,2366,1460,162,72,906,234,971,171929,-169,23020
"Fort Walton Beach-Crestview-Destin FL",2002,2405,1366,3496,-573,1039,2923,3903,175832,-59,23020
"Fort Walton Beach-Crestview-Destin FL",2003,2503,1353,3338,-1824,1150,1514,2686,178518,22,23020
"Fort Walton Beach-Crestview-Destin FL",2004,2583,1469,1663,960,1114,2623,3558,182076,-179,23020
"Fort Walton Beach-Crestview-Destin FL",2005,2783,1439,-14,-14,1344,-28,1183,183259,-133,23020
"Fort Walton Beach-Crestview-Destin FL",2006,2790,1406,-2237,514,1384,-1723,-425,182834,-86,23020
"Fort Walton Beach-Crestview-Destin FL",2007,2690,1418,-2860,-55,1272,-2915,-1747,181087,-104,23020
"Fort Walton Beach-Crestview-Destin FL",2008,2677,1416,-2602,171,1261,-2431,-1394,179693,-224,23020
"Fort Wayne IN",2000,1468,772,-78,214,696,136,867,391023,35,23060
"Fort Wayne IN",2001,6134,3088,-1070,834,3046,-236,2446,393469,-364,23060
"Fort Wayne IN",2002,6055,3206,-892,776,2849,-116,2377,395846,-356,23060
"Fort Wayne IN",2003,5954,3132,-518,666,2822,148,2428,398274,-542,23060
"Fort Wayne IN",2004,6060,3166,-1723,643,2894,-1080,1504,399778,-310,23060
"Fort Wayne IN",2005,6049,3117,-865,657,2932,-208,2359,402137,-365,23060
"Fort Wayne IN",2006,6170,3207,110,677,2963,787,3548,405685,-202,23060
"Fort Wayne IN",2007,6171,3206,-94,619,2965,525,3492,409177,2,23060
"Fort Wayne IN",2008,6237,3259,-1761,619,2978,-1142,1977,411154,141,23060
"Fresno CA",2000,3469,1301,-851,1333,2168,482,2716,802123,66,23420
"Fresno CA",2001,14226,5478,-1734,5117,8748,3383,11353,813476,-778,23420
"Fresno CA",2002,14453,5765,3470,4824,8688,8294,16253,829729,-729,23420
"Fresno CA",2003,15176,5664,3757,4228,9512,7985,16481,846210,-1016,23420
"Fresno CA",2004,15596,6013,657,3844,9583,4501,13519,859729,-565,23420
"Fresno CA",2005,15993,5837,-2473,4041,10156,1568,10891,870620,-833,23420
"Fresno CA",2006,16413,6026,-2426,4028,10387,1602,11551,882171,-438,23420
"Fresno CA",2007,16977,6101,-2048,3668,10876,1620,12577,894748,81,23420
"Fresno CA",2008,17406,6052,-883,3676,11354,2793,14405,909153,258,23420
"Gadsden AL",2000,337,298,-217,25,39,-192,-151,103308,2,23460
"Gadsden AL",2001,1365,1351,-441,92,14,-349,-426,102882,-91,23460
"Gadsden AL",2002,1310,1299,-132,84,11,-48,-133,102749,-96,23460
"Gadsden AL",2003,1215,1330,41,68,-115,109,-152,102597,-146,23460
"Gadsden AL",2004,1240,1347,31,71,-107,102,-72,102525,-67,23460
"Gadsden AL",2005,1228,1362,68,72,-134,140,-92,102433,-98,23460
"Gadsden AL",2006,1259,1383,416,74,-124,490,318,102751,-48,23460
"Gadsden AL",2007,1329,1341,249,66,-12,315,329,103080,26,23460
"Gadsden AL",2008,1283,1326,128,66,-43,194,223,103303,72,23460
"Gainesville FL",2000,664,411,222,232,253,454,719,233115,12,23540
"Gainesville FL",2001,2677,1680,1066,873,997,1939,2724,235839,-212,23540
"Gainesville FL",2002,2647,1704,1341,819,943,2160,2886,238725,-217,23540
"Gainesville FL",2003,2620,1718,1030,706,902,1736,2329,241054,-309,23540
"Gainesville FL",2004,2731,1785,1217,667,946,1884,2647,243701,-183,23540
"Gainesville FL",2005,2882,1703,2203,698,1179,2901,3877,247578,-203,23540
"Gainesville FL",2006,2851,1779,3650,751,1072,4401,5337,252915,-136,23540
"Gainesville FL",2007,3149,1791,1544,678,1358,2222,3502,256417,-78,23540
"Gainesville FL",2008,3180,1777,70,679,1403,749,2138,258555,-14,23540
"Gainesville GA",2000,680,232,667,450,448,1117,1564,140879,-1,23580
"Gainesville GA",2001,2858,1021,2245,1771,1837,4016,5919,146798,66,23580
"Gainesville GA",2002,2929,1046,1244,1668,1883,2912,4826,151624,31,23580
"Gainesville GA",2003,2933,1068,751,1478,1865,2229,4063,155687,-31,23580
"Gainesville GA",2004,2935,1140,643,1335,1795,1978,3812,159499,39,23580
"Gainesville GA",2005,3111,1032,1938,1408,2079,3346,5448,164947,23,23580
"Gainesville GA",2006,3016,1116,3198,1403,1900,4601,6497,171444,-4,23580
"Gainesville GA",2007,3162,1179,3920,1288,1983,5208,7176,178620,-15,23580
"Gainesville GA",2008,3385,1191,2749,1290,2194,4039,6194,184814,-39,23580
"Glens Falls NY",2000,292,267,-34,7,25,-27,4,124349,6,24020
"Glens Falls NY",2001,1249,1239,377,41,10,418,304,124653,-124,24020
"Glens Falls NY",2002,1306,1161,276,37,145,313,347,125000,-111,24020
"Glens Falls NY",2003,1256,1193,902,25,63,927,872,125872,-118,24020
"Glens Falls NY",2004,1283,1243,896,40,40,936,870,126742,-106,24020
"Glens Falls NY",2005,1293,1145,624,35,148,659,687,127429,-120,24020
"Glens Falls NY",2006,1228,1182,561,39,46,600,587,128016,-59,24020
"Glens Falls NY",2007,1330,1255,335,26,75,361,454,128470,18,24020
"Glens Falls NY",2008,1403,1262,61,30,141,91,305,128775,73,24020
"Goldsboro NC",2000,398,252,-317,135,146,-182,-35,113294,1,24140
"Goldsboro NC",2001,1758,1073,-1224,224,685,-1000,-400,112894,-85,24140
"Goldsboro NC",2002,1734,1012,-822,38,722,-784,-154,112740,-92,24140
"Goldsboro NC",2003,1663,1042,-86,-387,621,-473,-24,112716,-172,24140
"Goldsboro NC",2004,1739,1093,-199,441,646,242,813,113529,-75,24140
"Goldsboro NC",2005,1793,1088,-1128,190,705,-938,-326,113203,-93,24140
"Goldsboro NC",2006,1806,1053,-1622,318,753,-1304,-600,112603,-49,24140
"Goldsboro NC",2007,1806,1060,-59,137,746,78,793,113396,-31,24140
"Goldsboro NC",2008,1839,1055,-692,226,784,-466,275,113671,-43,24140
"Grand Forks ND-MN",2000,316,161,-369,67,155,-302,-150,97328,-3,24220
"Grand Forks ND-MN",2001,1154,815,-1307,116,339,-1191,-915,96413,-63,24220
"Grand Forks ND-MN",2002,1125,834,-564,-14,291,-578,-362,96051,-75,24220
"Grand Forks ND-MN",2003,1240,795,-3,-270,445,-273,27,96078,-145,24220
"Grand Forks ND-MN",2004,1302,811,1051,263,491,1314,1709,97787,-96,24220
"Grand Forks ND-MN",2005,1258,755,-1056,82,503,-974,-551,97236,-80,24220
"Grand Forks ND-MN",2006,1296,745,-204,184,551,-20,483,97719,-48,24220
"Grand Forks ND-MN",2007,1366,810,-1589,69,556,-1520,-938,96781,26,24220
"Grand Forks ND-MN",2008,1402,775,-238,112,627,-126,498,97279,-3,24220
"Grand Junction CO",2000,379,290,443,33,89,476,551,117486,-14,24300
"Grand Junction CO",2001,1513,1185,1451,131,328,1582,1798,119284,-112,24300
"Grand Junction CO",2002,1529,1165,2428,128,364,2556,2850,122134,-70,24300
"Grand Junction CO",2003,1555,1234,2011,106,321,2117,2389,124523,-49,24300
"Grand Junction CO",2004,1717,1203,2137,100,514,2237,2608,127131,-143,24300
"Grand Junction CO",2005,1757,1243,1874,106,514,1980,2394,129525,-100,24300
"Grand Junction CO",2006,1866,1279,3729,106,587,3835,4343,133868,-79,24300
"Grand Junction CO",2007,2033,1204,4073,92,829,4165,5015,138883,21,24300
"Grand Junction CO",2008,2169,1266,3329,93,903,3422,4288,143171,-37,24300
"Grand Rapids-Wyoming MI",2000,2931,1263,189,624,1668,813,2548,743038,67,24340
"Grand Rapids-Wyoming MI",2001,11736,5559,-806,2366,6177,1560,7041,750079,-696,24340
"Grand Rapids-Wyoming MI",2002,11336,5415,-1603,2220,5921,617,5892,755971,-646,24340
"Grand Rapids-Wyoming MI",2003,11327,5317,-2783,1932,6010,-851,4278,760249,-881,24340
"Grand Rapids-Wyoming MI",2004,11670,5570,-3650,1757,6100,-1893,3595,763844,-612,24340
"Grand Rapids-Wyoming MI",2005,11662,5739,-3033,1850,5923,-1183,4039,767883,-701,24340
"Grand Rapids-Wyoming MI",2006,11434,5409,-4163,1875,6025,-2288,3382,771265,-355,24340
"Grand Rapids-Wyoming MI",2007,11800,5225,-4627,1687,6575,-2940,3666,774931,31,24340
"Grand Rapids-Wyoming MI",2008,11875,5339,-6443,1687,6536,-4756,1902,776833,122,24340
"Great Falls MT",2000,242,171,-273,48,71,-225,-157,80200,-3,24500
"Great Falls MT",2001,1044,791,-529,-6,253,-535,180,80380,462,24500
"Great Falls MT",2002,1047,788,-245,-161,259,-406,210,80590,357,24500
"Great Falls MT",2003,1124,761,227,-460,363,-233,469,81059,339,24500
"Great Falls MT",2004,1119,751,-353,225,368,-128,631,81690,391,24500
"Great Falls MT",2005,1138,785,-604,-9,353,-613,101,81791,361,24500
"Great Falls MT",2006,1146,782,-782,113,364,-669,63,81854,368,24500
"Great Falls MT",2007,1177,670,-532,-25,507,-557,-70,81784,-20,24500
"Great Falls MT",2008,1177,742,-216,32,435,-184,242,82026,-9,24500
"Greeley CO",2000,798,255,1412,243,543,1655,2179,183036,-19,24540
"Greeley CO",2001,3205,1206,7092,966,1999,8058,10041,193077,-16,24540
"Greeley CO",2002,3382,1177,7431,900,2205,8331,10583,203660,47,24540
"Greeley CO",2003,3640,1223,3982,776,2417,4758,7176,210836,1,24540
"Greeley CO",2004,3904,1220,4063,729,2684,4792,7204,218040,-272,24540
"Greeley CO",2005,3851,1273,5189,753,2578,5942,8314,226354,-206,24540
"Greeley CO",2006,4021,1262,4976,752,2759,5728,8356,234710,-131,24540
"Greeley CO",2007,4128,1275,4316,686,2853,5002,7938,242648,83,24540
"Greeley CO",2008,4382,1294,3305,690,3088,3995,7127,249775,44,24540
"Green Bay WI",2000,994,531,222,120,463,342,820,283319,15,24580
"Green Bay WI",2001,3823,2133,583,520,1690,1103,2514,285833,-279,24580
"Green Bay WI",2002,3877,2158,928,490,1719,1418,2876,288709,-261,24580
"Green Bay WI",2003,3899,2037,348,419,1862,767,2221,290930,-408,24580
"Green Bay WI",2004,4056,2130,1283,401,1926,1684,3387,294317,-223,24580
"Green Bay WI",2005,3845,2041,117,414,1804,531,2067,296384,-268,24580
"Green Bay WI",2006,4031,2142,-247,427,1889,180,1923,298307,-146,24580
"Green Bay WI",2007,4128,2135,392,386,1993,778,2749,301056,-22,24580
"Green Bay WI",2008,4176,2080,-674,385,2096,-289,1879,302935,72,24580
"Greensboro-High Point NC",2000,2235,1357,271,783,878,1054,1981,645430,49,24660
"Greensboro-High Point NC",2001,9111,5606,896,2980,3505,3876,6763,652193,-618,24660
"Greensboro-High Point NC",2002,8887,5670,-1105,2795,3217,1690,4309,656502,-598,24660
"Greensboro-High Point NC",2003,8815,5606,-432,2462,3209,2030,4269,660771,-970,24660
"Greensboro-High Point NC",2004,8694,5766,-856,2246,2928,1390,3872,664643,-446,24660
"Greensboro-High Point NC",2005,8751,5865,4006,2359,2886,6365,8625,673268,-626,24660
"Greensboro-High Point NC",2006,8802,5875,6345,2364,2927,8709,11290,684558,-346,24660
"Greensboro-High Point NC",2007,9360,5787,5302,2146,3573,7448,11180,695738,159,24660
"Greensboro-High Point NC",2008,9515,5842,3859,2155,3673,6014,9946,705684,259,24660
"Greenville NC",2000,553,303,97,113,250,210,469,153162,9,24780
"Greenville NC",2001,2224,1234,581,414,990,995,1840,155002,-145,24780
"Greenville NC",2002,2233,1173,744,378,1060,1122,2050,157052,-132,24780
"Greenville NC",2003,2239,1268,848,317,971,1165,1958,159010,-178,24780
"Greenville NC",2004,2312,1292,1150,321,1020,1471,2349,161359,-142,24780
"Greenville NC",2005,2298,1249,1330,327,1049,1657,2568,163927,-138,24780
"Greenville NC",2006,2362,1289,3179,330,1073,3509,4490,168417,-92,24780
"Greenville NC",2007,2582,1244,2769,298,1338,3067,4421,172838,16,24780
"Greenville NC",2008,2623,1297,2268,305,1326,2573,3920,176758,21,24780
"Greenville-Mauldin-Easley SC",2000,1825,1101,756,444,724,1200,1949,561871,25,24860
"Greenville-Mauldin-Easley SC",2001,7462,5090,2231,1687,2372,3918,5778,567649,-512,24860
"Greenville-Mauldin-Easley SC",2002,7575,4993,548,1583,2582,2131,4214,571863,-499,24860
"Greenville-Mauldin-Easley SC",2003,7510,5038,1392,1363,2472,2755,4474,576337,-753,24860
"Greenville-Mauldin-Easley SC",2004,7684,4805,1747,1285,2879,3032,5470,581807,-441,24860
"Greenville-Mauldin-Easley SC",2005,7902,5007,3208,1336,2895,4544,6907,588714,-532,24860
"Greenville-Mauldin-Easley SC",2006,8204,5016,6573,1346,3188,7919,10795,599509,-312,24860
"Greenville-Mauldin-Easley SC",2007,8448,5271,8522,1219,3177,9741,13058,612567,140,24860
"Greenville-Mauldin-Easley SC",2008,8350,5298,7593,1229,3052,8822,12148,624715,274,24860
"Gulfport-Biloxi MS",2000,870,584,183,159,286,342,637,246834,9,25060
"Gulfport-Biloxi MS",2001,3693,2352,55,124,1341,179,1313,248147,-207,25060
"Gulfport-Biloxi MS",2002,3646,2392,844,-286,1254,558,1599,249746,-213,25060
"Gulfport-Biloxi MS",2003,3635,2360,355,-1132,1275,-777,161,249907,-337,25060
"Gulfport-Biloxi MS",2004,3694,2411,2628,712,1283,3340,4379,254286,-244,25060
"Gulfport-Biloxi MS",2005,3698,2436,1140,79,1262,1219,2253,256539,-228,25060
"Gulfport-Biloxi MS",2006,3125,2400,-30486,439,725,-30047,-29341,227198,-19,25060
"Gulfport-Biloxi MS",2007,3645,1965,3032,58,1680,3090,4458,231656,-312,25060
"Gulfport-Biloxi MS",2008,3526,2033,1807,186,1493,1993,2969,234625,-517,25060
"Hagerstown-Martinsburg MD-WV",2000,687,483,523,21,204,544,752,223523,4,25180
"Hagerstown-Martinsburg MD-WV",2001,2809,2106,2538,107,703,2645,3184,226707,-164,25180
"Hagerstown-Martinsburg MD-WV",2002,2863,2148,3489,87,715,3576,4161,230868,-130,25180
"Hagerstown-Martinsburg MD-WV",2003,2982,2194,4850,37,788,4887,5688,236556,13,25180
"Hagerstown-Martinsburg MD-WV",2004,3134,2306,5814,106,828,5920,6409,242965,-339,25180
"Hagerstown-Martinsburg MD-WV",2005,3110,2305,5883,80,805,5963,6545,249510,-223,25180
"Hagerstown-Martinsburg MD-WV",2006,3385,2192,5205,102,1193,5307,6364,255874,-136,25180
"Hagerstown-Martinsburg MD-WV",2007,3374,2252,3413,77,1122,3490,4665,260539,53,25180
"Hagerstown-Martinsburg MD-WV",2008,3459,2315,1916,79,1144,1995,3214,263753,75,25180
"Hanford-Corcoran CA",2000,503,147,-253,206,356,-47,315,129776,6,25260
"Hanford-Corcoran CA",2001,2223,715,766,566,1508,1332,2726,132502,-114,25260
"Hanford-Corcoran CA",2002,2203,714,540,367,1489,907,2279,134781,-117,25260
"Hanford-Corcoran CA",2003,2334,784,2614,-63,1550,2551,4098,138879,-3,25260
"Hanford-Corcoran CA",2004,2408,846,1390,692,1562,2082,3511,142390,-133,25260
"Hanford-Corcoran CA",2005,2617,751,-1084,465,1866,-619,1117,143507,-130,25260
"Hanford-Corcoran CA",2006,2600,827,-54,571,1773,517,2216,145723,-74,25260
"Hanford-Corcoran CA",2007,2701,786,228,378,1915,606,2509,148232,-12,25260
"Hanford-Corcoran CA",2008,2747,810,-1139,464,1937,-675,1286,149518,24,25260
"Harrisburg-Carlisle PA",2000,1498,1147,-262,212,351,-50,312,509396,11,25420
"Harrisburg-Carlisle PA",2001,5972,4849,-502,792,1123,290,942,510338,-471,25420
"Harrisburg-Carlisle PA",2002,5895,4803,1758,683,1092,2441,3064,513402,-469,25420
"Harrisburg-Carlisle PA",2003,5804,4839,1534,474,965,2008,2357,515759,-616,25420
"Harrisburg-Carlisle PA",2004,6091,5001,105,693,1090,798,1495,517254,-393,25420
"Harrisburg-Carlisle PA",2005,6286,5037,1075,620,1249,1695,2493,519747,-451,25420
"Harrisburg-Carlisle PA",2006,6248,4782,2391,761,1466,3152,4353,524100,-265,25420
"Harrisburg-Carlisle PA",2007,6460,4913,1699,624,1547,2323,3780,527880,-90,25420
"Harrisburg-Carlisle PA",2008,6422,4858,1043,640,1564,1683,3228,531108,-19,25420
"Harrisonburg VA",2000,299,183,-100,102,116,2,114,108283,-4,25500
"Harrisonburg VA",2001,1383,865,522,420,518,942,1558,109841,98,25500
"Harrisonburg VA",2002,1365,789,368,396,576,764,1275,111116,-65,25500
"Harrisonburg VA",2003,1349,819,-419,336,530,-83,387,111503,-60,25500
"Harrisonburg VA",2004,1415,844,12,328,571,340,883,112386,-28,25500
"Harrisonburg VA",2005,1390,873,547,336,517,883,1770,114156,370,25500
"Harrisonburg VA",2006,1451,891,755,360,560,1115,1906,116062,231,25500
"Harrisonburg VA",2007,1508,868,402,320,640,722,1367,117429,5,25500
"Harrisonburg VA",2008,1597,872,-74,320,725,246,980,118409,9,25500
"Hartford-West Hartford-East Hartford CT",2000,3440,2281,40,1031,1159,1071,2286,1150906,56,25540
"Hartford-West Hartford-East Hartford CT",2001,13993,10579,-119,3837,3414,3718,6023,1156929,-1109,25540
"Hartford-West Hartford-East Hartford CT",2002,13781,9913,2210,3600,3868,5810,8655,1165584,-1023,25540
"Hartford-West Hartford-East Hartford CT",2003,13713,10374,3058,3156,3339,6214,7987,1173571,-1566,25540
"Hartford-West Hartford-East Hartford CT",2004,13862,10172,-3956,3027,3690,-929,1860,1175431,-901,25540
"Hartford-West Hartford-East Hartford CT",2005,13601,10227,-2018,3129,3374,1111,3379,1178810,-1106,25540
"Hartford-West Hartford-East Hartford CT",2006,13475,10102,-2132,3790,3373,1658,4475,1183285,-556,25540
"Hartford-West Hartford-East Hartford CT",2007,13712,9555,-4207,3315,4157,-892,3200,1186485,-65,25540
"Hartford-West Hartford-East Hartford CT",2008,13893,9603,-3686,3334,4290,-352,4027,1190512,89,25540
"Hattiesburg MS",2000,454,267,282,48,187,330,518,124330,1,25620
"Hattiesburg MS",2001,1854,1129,296,120,725,416,1018,125348,-123,25620
"Hattiesburg MS",2002,1852,1177,652,84,675,736,1306,126654,-105,25620
"Hattiesburg MS",2003,1893,1128,771,6,765,777,1398,128052,-144,25620
"Hattiesburg MS",2004,1938,1144,900,141,794,1041,1716,129768,-119,25620
"Hattiesburg MS",2005,1986,1137,1137,95,849,1232,1971,131739,-110,25620
"Hattiesburg MS",2006,2072,1189,2415,125,883,2540,3344,135083,-79,25620
"Hattiesburg MS",2007,2325,1125,2098,83,1200,2181,3386,138469,5,25620
"Hattiesburg MS",2008,2297,1113,1030,96,1184,1126,2312,140781,2,25620
"Hickory-Lenoir-Morganton NC",2000,1210,762,554,264,448,818,1283,343103,17,25860
"Hickory-Lenoir-Morganton NC",2001,4659,3215,1165,1037,1444,2202,3619,346722,-27,25860
"Hickory-Lenoir-Morganton NC",2002,4557,3111,-956,979,1446,23,1388,348110,-81,25860
"Hickory-Lenoir-Morganton NC",2003,4348,3150,-921,813,1198,-108,706,348816,-384,25860
"Hickory-Lenoir-Morganton NC",2004,4291,3303,412,775,988,1187,1963,350779,-212,25860
"Hickory-Lenoir-Morganton NC",2005,4406,3331,1129,814,1075,1943,2753,353532,-265,25860
"Hickory-Lenoir-Morganton NC",2006,4325,3382,1070,820,943,1890,2699,356231,-134,25860
"Hickory-Lenoir-Morganton NC",2007,4549,3256,1230,740,1293,1970,3338,359569,75,25860
"Hickory-Lenoir-Morganton NC",2008,4542,3245,1315,750,1297,2065,3467,363036,105,25860
"Hinesville-Fort Stewart GA",2000,397,76,-622,189,321,-433,-122,71792,-10,25980
"Hinesville-Fort Stewart GA",2001,1606,353,-2250,30,1253,-2220,-985,70807,-18,25980
"Hinesville-Fort Stewart GA",2002,1573,318,644,-560,1255,84,1284,72091,-55,25980
"Hinesville-Fort Stewart GA",2003,1539,324,-224,-1859,1215,-2083,-961,71130,-93,25980
"Hinesville-Fort Stewart GA",2004,1434,366,-289,936,1068,647,1652,72782,-63,25980
"Hinesville-Fort Stewart GA",2005,1700,335,-248,-14,1365,-262,1040,73822,-63,25980
"Hinesville-Fort Stewart GA",2006,1197,346,-3699,504,851,-3195,-2360,71462,-16,25980
"Hinesville-Fort Stewart GA",2007,1603,398,-883,-67,1205,-950,264,71726,9,25980
"Hinesville-Fort Stewart GA",2008,1446,367,-3058,161,1079,-2897,-1783,69943,35,25980
"Holland-Grand Haven MI",2000,942,330,426,96,612,522,1148,239462,14,26100
"Holland-Grand Haven MI",2001,3659,1433,1596,373,2226,1969,3976,243438,-219,26100
"Holland-Grand Haven MI",2002,3615,1499,586,349,2116,935,2801,246239,-250,26100
"Holland-Grand Haven MI",2003,3431,1490,976,301,1941,1277,2890,249129,-328,26100
"Holland-Grand Haven MI",2004,3613,1530,919,280,2083,1199,3100,252229,-182,26100
"Holland-Grand Haven MI",2005,3503,1512,-46,294,1991,248,2002,254231,-237,26100
"Holland-Grand Haven MI",2006,3593,1516,33,297,2077,330,2281,256512,-126,26100
"Holland-Grand Haven MI",2007,3608,1511,-443,266,2097,-177,1949,258461,29,26100
"Holland-Grand Haven MI",2008,3801,1523,-751,266,2278,-485,1903,260364,110,26100
"Honolulu HI",2000,3075,1507,-4308,1656,1568,-2652,-1104,875054,-20,26180
"Honolulu HI",2001,12751,5928,-8112,3937,6823,-4175,1970,877024,-678,26180
"Honolulu HI",2002,12756,6184,-2161,1635,6572,-526,5254,882278,-792,26180
"Honolulu HI",2003,13088,6034,2296,-2930,7054,-634,5298,887576,-1122,26180
"Honolulu HI",2004,13500,6393,-5942,5902,7107,-40,6303,893879,-764,26180
"Honolulu HI",2005,13048,6335,-3024,2925,6713,-99,5794,899673,-820,26180
"Honolulu HI",2006,13362,6380,-6571,4475,6982,-2096,4461,904134,-425,26180
"Honolulu HI",2007,13677,6365,-13868,2435,7312,-11433,-3609,900525,512,26180
"Honolulu HI",2008,13521,6603,-6191,3260,6918,-2931,4509,905034,522,26180
"Hot Springs AR",2000,251,293,313,12,-42,325,280,88348,-3,26300
"Hot Springs AR",2001,992,1218,1161,70,-226,1231,950,89298,-55,26300
"Hot Springs AR",2002,1018,1330,1121,63,-312,1184,826,90124,-46,26300
"Hot Springs AR",2003,1086,1290,1220,45,-204,1265,1037,91161,-24,26300
"Hot Springs AR",2004,1114,1281,1026,61,-167,1087,826,91987,-94,26300
"Hot Springs AR",2005,1090,1319,1466,55,-229,1521,1210,93197,-82,26300
"Hot Springs AR",2006,1158,1185,1948,59,-27,2007,1930,95127,-50,26300
"Hot Springs AR",2007,1220,1224,1033,51,-4,1084,1118,96245,38,26300
"Hot Springs AR",2008,1215,1285,1174,52,-70,1226,1220,97465,64,26300
"Houma-Bayou Cane-Thibodaux LA",2000,723,326,-474,24,397,-450,-50,194427,3,26380
"Houma-Bayou Cane-Thibodaux LA",2001,2963,1606,-968,117,1357,-851,337,194764,-169,26380
"Houma-Bayou Cane-Thibodaux LA",2002,2798,1570,-369,108,1228,-261,800,195564,-167,26380
"Houma-Bayou Cane-Thibodaux LA",2003,2974,1570,-409,77,1404,-332,814,196378,-258,26380
"Houma-Bayou Cane-Thibodaux LA",2004,2907,1547,-647,99,1360,-548,665,197043,-147,26380
"Houma-Bayou Cane-Thibodaux LA",2005,2871,1591,-719,94,1280,-625,471,197514,-184,26380
"Houma-Bayou Cane-Thibodaux LA",2006,2725,1777,2362,101,948,2463,3304,200818,-107,26380
"Houma-Bayou Cane-Thibodaux LA",2007,3075,1709,-1095,89,1366,-1006,202,201020,-158,26380
"Houma-Bayou Cane-Thibodaux LA",2008,2953,1641,-1043,93,1312,-950,128,201148,-234,26380
"Houston-Sugar Land-Baytown TX",2000,19654,6789,1020,10173,12865,11193,24208,4739625,150,26420
"Houston-Sugar Land-Baytown TX",2001,83630,29529,4570,40772,54101,45342,112324,4851949,12881,26420
"Houston-Sugar Land-Baytown TX",2002,84835,30437,24498,38474,54398,62972,127990,4979939,10620,26420
"Houston-Sugar Land-Baytown TX",2003,88281,30113,2895,33667,58168,36562,106073,5086012,11343,26420
"Houston-Sugar Land-Baytown TX",2004,89031,29922,6427,30705,59109,37132,107017,5193029,10776,26420
"Houston-Sugar Land-Baytown TX",2005,90064,30127,6187,32283,59937,38470,109879,5302908,11472,26420
"Houston-Sugar Land-Baytown TX",2006,92424,30636,88885,32227,61788,121112,182637,5485545,-263,26420
"Houston-Sugar Land-Baytown TX",2007,95104,31973,19981,29330,63131,49311,112413,5597958,-29,26420
"Houston-Sugar Land-Baytown TX",2008,96953,32814,36724,29392,64139,66116,130185,5728143,-70,26420
"Huntington-Ashland WV-KY-OH",2000,807,777,-345,17,30,-328,-294,288357,4,26580
"Huntington-Ashland WV-KY-OH",2001,3492,3340,-1335,81,152,-1254,-1359,286998,-257,26580
"Huntington-Ashland WV-KY-OH",2002,3304,3461,-702,72,-157,-630,-1054,285944,-267,26580
"Huntington-Ashland WV-KY-OH",2003,3356,3365,441,48,-9,489,118,286062,-362,26580
"Huntington-Ashland WV-KY-OH",2004,3410,3475,-716,73,-65,-643,-906,285156,-198,26580
"Huntington-Ashland WV-KY-OH",2005,3364,3482,-464,62,-118,-402,-764,284392,-244,26580
"Huntington-Ashland WV-KY-OH",2006,3466,3282,-286,70,184,-216,-165,284227,-133,26580
"Huntington-Ashland WV-KY-OH",2007,3432,3334,-394,59,98,-335,-284,283943,-47,26580
"Huntington-Ashland WV-KY-OH",2008,3419,3360,214,61,59,275,291,284234,-43,26580
"Huntsville AL",2000,1163,657,475,150,506,625,1139,343767,8,26620
"Huntsville AL",2001,4628,2759,1546,537,1869,2083,3987,347754,35,26620
"Huntsville AL",2002,4318,2684,2966,449,1634,3415,5089,352843,40,26620
"Huntsville AL",2003,4395,2854,3271,283,1541,3554,5141,357984,46,26620
"Huntsville AL",2004,4407,2947,2546,491,1460,3037,4579,362563,82,26620
"Huntsville AL",2005,4676,2913,4499,414,1763,4913,6605,369168,-71,26620
"Huntsville AL",2006,4747,2907,6283,487,1840,6770,8579,377747,-31,26620
"Huntsville AL",2007,5063,3049,5979,394,2014,6373,8575,386322,188,26620
"Huntsville AL",2008,5096,3112,6764,405,1984,7169,9323,395645,170,26620
"Idaho Falls ID",2000,459,130,29,28,329,57,393,102070,7,26820
"Idaho Falls ID",2001,1854,725,-344,159,1129,-185,846,102916,-98,26820
"Idaho Falls ID",2002,1852,753,239,153,1099,392,1384,104300,-107,26820
"Idaho Falls ID",2003,1947,744,708,119,1203,827,1916,106216,-114,26820
"Idaho Falls ID",2004,2100,778,1670,126,1322,1796,3001,109217,-117,26820
"Idaho Falls ID",2005,2228,725,1167,124,1503,1291,2698,111915,-96,26820
"Idaho Falls ID",2006,2264,753,1779,126,1511,1905,3350,115265,-66,26820
"Idaho Falls ID",2007,2406,800,2170,106,1606,2276,3868,119133,-14,26820
"Idaho Falls ID",2008,2465,796,2098,108,1669,2206,3862,122995,-13,26820
"Indianapolis-Carmel IN",2000,5914,2957,2256,845,2957,3101,5976,1531079,-82,26900
"Indianapolis-Carmel IN",2001,24521,12655,9196,3183,11866,12379,24621,1555700,376,26900
"Indianapolis-Carmel IN",2002,24308,12482,6437,2946,11826,9383,21789,1577489,580,26900
"Indianapolis-Carmel IN",2003,24654,12338,6026,2503,12316,8529,21579,1599068,734,26900
"Indianapolis-Carmel IN",2004,25487,12678,7102,2440,12809,9542,22411,1621479,60,26900
"Indianapolis-Carmel IN",2005,25104,12874,7720,2477,12230,10197,21593,1643072,-834,26900
"Indianapolis-Carmel IN",2006,25713,12568,10113,2531,13145,12644,25176,1668248,-613,26900
"Indianapolis-Carmel IN",2007,26098,12831,8815,2298,13267,11113,24489,1692737,109,26900
"Indianapolis-Carmel IN",2008,26361,12789,6707,2301,13572,9008,22722,1715459,142,26900
"Iowa City IA",2000,426,169,73,146,257,219,486,132162,10,26980
"Iowa City IA",2001,1672,704,941,567,968,1508,2692,134854,216,26980
"Iowa City IA",2002,1738,787,31,537,951,568,1673,136527,154,26980
"Iowa City IA",2003,1788,778,346,464,1010,810,1941,138468,121,26980
"Iowa City IA",2004,1906,736,730,422,1170,1152,2325,140793,3,26980
"Iowa City IA",2005,1733,781,132,443,952,575,1500,142293,-27,26980
"Iowa City IA",2006,1802,766,521,448,1036,969,1995,144288,-10,26980
"Iowa City IA",2007,1976,723,731,404,1253,1135,2402,146690,14,26980
"Iowa City IA",2008,1988,740,1061,403,1248,1464,2747,149437,35,26980
"Ithaca NY",2000,229,150,-106,180,79,74,154,96656,1,27060
"Ithaca NY",2001,828,610,69,730,218,799,916,97572,-101,27060
"Ithaca NY",2002,867,576,-40,692,291,652,846,98418,-97,27060
"Ithaca NY",2003,891,585,93,608,306,701,854,99272,-153,27060
"Ithaca NY",2004,954,556,-289,559,398,270,598,99870,-70,27060
"Ithaca NY",2005,914,633,-761,586,281,-175,17,99887,-89,27060
"Ithaca NY",2006,808,546,-629,592,262,-37,180,100067,-45,27060
"Ithaca NY",2007,959,587,-562,530,372,-32,334,100401,-6,27060
"Ithaca NY",2008,1017,560,-250,532,457,282,735,101136,-4,27060
"Jackson MI",2000,516,332,96,25,184,121,317,158739,12,27100
"Jackson MI",2001,2043,1429,449,106,614,555,1022,159761,-147,27100
"Jackson MI",2002,1989,1446,539,99,543,638,1041,160802,-140,27100
"Jackson MI",2003,2070,1520,619,73,550,692,1037,161839,-205,27100
"Jackson MI",2004,2154,1607,-558,83,547,-475,-49,161790,-121,27100
"Jackson MI",2005,2124,1614,347,81,510,428,783,162573,-155,27100
"Jackson MI",2006,2018,1536,-207,92,482,-115,294,162867,-73,27100
"Jackson MI",2007,2079,1448,-898,81,631,-817,-161,162706,25,27100
"Jackson MI",2008,2164,1481,-3358,81,683,-3277,-2526,160180,68,27100
"Jackson MS",2000,1816,1064,251,75,752,326,1054,498254,-24,27140
"Jackson MS",2001,7778,4363,-356,296,3415,-60,2910,501164,-445,27140
"Jackson MS",2002,7524,4387,226,249,3137,475,3200,504364,-412,27140
"Jackson MS",2003,7761,4532,1706,117,3229,1823,4621,508985,-431,27140
"Jackson MS",2004,7890,4420,3627,275,3470,3902,6894,515879,-478,27140
"Jackson MS",2005,7924,4483,2207,222,3441,2429,5451,521330,-419,27140
"Jackson MS",2006,8330,4511,5406,257,3819,5663,9201,530531,-281,27140
"Jackson MS",2007,8775,4433,-1123,208,4342,-915,3263,533794,-164,27140
"Jackson MS",2008,8610,4540,-494,224,4070,-270,3491,537285,-309,27140
"Jackson TN",2000,342,241,59,35,101,94,203,107568,8,27180
"Jackson TN",2001,1546,1044,657,153,502,810,1220,108788,-92,27180
"Jackson TN",2002,1511,1003,-45,150,508,105,507,109295,-106,27180
"Jackson TN",2003,1510,1070,-537,125,440,-412,-94,109201,-122,27180
"Jackson TN",2004,1545,999,135,113,546,248,714,109915,-80,27180
"Jackson TN",2005,1523,1053,252,124,470,376,748,110663,-98,27180
"Jackson TN",2006,1524,1038,779,125,486,904,1333,111996,-57,27180
"Jackson TN",2007,1591,1066,-248,107,525,-141,394,112390,10,27180
"Jackson TN",2008,1585,1068,-365,108,517,-257,295,112685,35,27180
"Jacksonville FL",2000,3897,2226,893,852,1671,1745,3432,1126182,16,27260
"Jacksonville FL",2001,16378,9897,14164,1955,6481,16119,21740,1147922,-860,27260
"Jacksonville FL",2002,16327,9915,17992,814,6412,18806,24571,1172493,-647,27260
"Jacksonville FL",2003,16688,10520,17543,-1437,6168,16106,21760,1194253,-514,27260
"Jacksonville FL",2004,17397,10807,19733,2945,6590,22678,27901,1222154,-1367,27260
"Jacksonville FL",2005,17714,10236,17781,1440,7478,19221,25640,1247794,-1059,27260
"Jacksonville FL",2006,18747,10501,18753,2398,8246,21151,28701,1276495,-696,27260
"Jacksonville FL",2007,18818,10331,11405,1310,8487,12715,21318,1297813,116,27260
"Jacksonville FL",2008,19103,10509,4768,1676,8594,6444,15415,1313228,377,27260
"Jacksonville NC",2000,766,151,-1750,588,615,-1162,-579,149776,-32,27340
"Jacksonville NC",2001,3253,830,-2041,-390,2423,-2431,-112,149664,-104,27340
"Jacksonville NC",2002,3087,766,3289,-1954,2321,1335,3616,153280,-40,27340
"Jacksonville NC",2003,3168,750,5699,-5607,2418,92,2759,156039,249,27340
"Jacksonville NC",2004,3285,763,513,2297,2522,2810,5205,161244,-127,27340
"Jacksonville NC",2005,3293,856,-4494,-155,2437,-4649,-2318,158926,-106,27340
"Jacksonville NC",2006,3223,819,-1326,973,2404,-353,1970,160896,-81,27340
"Jacksonville NC",2007,3771,815,156,-587,2956,-431,2440,163336,-85,27340
"Jacksonville NC",2008,3556,834,-226,231,2722,5,2602,165938,-125,27340
"Janesville WI",2000,518,310,-99,71,208,-28,189,152496,9,27500
"Janesville WI",2001,2071,1328,-218,281,743,63,660,153156,-146,27500
"Janesville WI",2002,1980,1328,-420,270,652,-150,366,153522,-136,27500
"Janesville WI",2003,2041,1293,-312,239,748,-73,467,153989,-208,27500
"Janesville WI",2004,2040,1334,585,217,706,802,1393,155382,-115,27500
"Janesville WI",2005,1977,1355,312,228,622,540,1012,156394,-150,27500
"Janesville WI",2006,2099,1433,835,228,666,1063,1652,158046,-77,27500
"Janesville WI",2007,2198,1273,219,209,925,428,1352,159398,-1,27500
"Janesville WI",2008,2198,1259,-368,208,939,-160,815,160213,36,27500
"Jefferson City MO",2000,420,276,91,27,144,118,264,140317,2,27620
"Jefferson City MO",2001,1740,1251,93,129,489,222,584,140901,-127,27620
"Jefferson City MO",2002,1786,1230,497,113,556,610,1038,141939,-128,27620
"Jefferson City MO",2003,1830,1133,118,72,697,190,703,142642,-184,27620
"Jefferson City MO",2004,1886,1247,-1458,123,639,-1335,-835,141807,-139,27620
"Jefferson City MO",2005,1951,1193,861,107,758,968,1600,143407,-126,27620
"Jefferson City MO",2006,1844,1190,376,119,654,495,1078,144485,-71,27620
"Jefferson City MO",2007,1999,1096,-323,98,903,-225,685,145170,7,27620
"Jefferson City MO",2008,1983,1114,182,104,869,286,1193,146363,38,27620
"Johnson City TN",2000,558,487,292,26,71,318,391,181996,2,27740
"Johnson City TN",2001,2013,1996,120,128,17,248,80,182076,-185,27740
"Johnson City TN",2002,2016,2011,1640,118,5,1758,1628,183704,-135,27740
"Johnson City TN",2003,2078,2054,2340,95,24,2435,2364,186068,-95,27740
"Johnson City TN",2004,2201,2170,1045,113,31,1158,1041,187109,-148,27740
"Johnson City TN",2005,2135,2059,1658,108,76,1766,1685,188794,-157,27740
"Johnson City TN",2006,2167,2133,2382,114,34,2496,2431,191225,-99,27740
"Johnson City TN",2007,2189,2138,1946,101,51,2047,2070,193295,-28,27740
"Johnson City TN",2008,2265,2113,2268,105,152,2373,2554,195849,29,27740
"Johnstown PA",2000,378,461,-312,7,-83,-305,-389,152209,-1,27780
"Johnstown PA",2001,1524,2030,-642,46,-506,-596,-1241,150968,-139,27780
"Johnstown PA",2002,1509,1915,-639,41,-406,-598,-1135,149833,-131,27780
"Johnstown PA",2003,1439,1910,-481,25,-471,-456,-1123,148710,-196,27780
"Johnstown PA",2004,1529,1869,-579,45,-340,-534,-982,147728,-108,27780
"Johnstown PA",2005,1518,1915,-474,37,-397,-437,-964,146764,-130,27780
"Johnstown PA",2006,1454,1887,-387,46,-433,-341,-842,145922,-68,27780
"Johnstown PA",2007,1498,1852,-590,33,-354,-557,-926,144996,-15,27780
"Johnstown PA",2008,1514,1787,-426,34,-273,-392,-677,144319,-12,27780
"Jonesboro AR",2000,397,257,209,29,140,238,377,108139,-1,27860
"Jonesboro AR",2001,1556,1028,87,134,528,221,646,108785,-103,27860
"Jonesboro AR",2002,1515,1155,27,128,360,155,422,109207,-93,27860
"Jonesboro AR",2003,1519,1089,519,113,430,632,932,110139,-130,27860
"Jonesboro AR",2004,1613,1177,756,109,436,865,1202,111341,-99,27860
"Jonesboro AR",2005,1655,1159,645,111,496,756,1159,112500,-93,27860
"Jonesboro AR",2006,1581,1118,1436,112,463,1548,1951,114451,-60,27860
"Jonesboro AR",2007,1766,1100,344,100,666,444,1097,115548,-13,27860
"Jonesboro AR",2008,1793,1106,1023,100,687,1123,1813,117361,3,27860
"Joplin MO",2000,597,366,103,45,231,148,388,157710,9,27900
"Joplin MO",2001,2446,1637,39,199,809,238,886,158596,-161,27900
"Joplin MO",2002,2463,1654,625,189,809,814,1482,160078,-141,27900
"Joplin MO",2003,2398,1642,1070,149,756,1219,1807,161885,-168,27900
"Joplin MO",2004,2422,1639,1108,161,783,1269,1915,163800,-137,27900
"Joplin MO",2005,2550,1556,1074,159,994,1233,2075,165875,-152,27900
"Joplin MO",2006,2559,1622,1444,168,937,1612,2461,168336,-88,27900
"Joplin MO",2007,2699,1592,1451,147,1107,1598,2707,171043,2,27900
"Joplin MO",2008,2741,1578,550,152,1163,702,1890,172933,25,27900
"Kalamazoo-Portage MI",2000,1082,593,-150,149,489,-1,511,315377,23,28020
"Kalamazoo-Portage MI",2001,4208,2637,-543,619,1571,76,1345,316722,-302,28020
"Kalamazoo-Portage MI",2002,4203,2572,330,581,1631,911,2238,318960,-304,28020
"Kalamazoo-Portage MI",2003,4082,2680,583,499,1402,1082,2041,321001,-443,28020
"Kalamazoo-Portage MI",2004,4239,2548,-2905,469,1691,-2436,-1042,319959,-297,28020
"Kalamazoo-Portage MI",2005,4106,2627,-1178,488,1479,-690,498,320457,-291,28020
"Kalamazoo-Portage MI",2006,4180,2557,-988,494,1623,-494,979,321436,-150,28020
"Kalamazoo-Portage MI",2007,4264,2498,-1345,439,1766,-906,904,322340,44,28020
"Kalamazoo-Portage MI",2008,4381,2538,-1013,439,1843,-574,1373,323713,104,28020
"Kankakee-Bradley IL",2000,375,247,-121,31,128,-90,43,103876,5,28100
"Kankakee-Bradley IL",2001,1538,1154,162,150,384,312,929,104805,233,28100
"Kankakee-Bradley IL",2002,1567,1127,-175,143,440,-32,591,105396,183,28100
"Kankakee-Bradley IL",2003,1538,1057,181,119,481,300,672,106068,-109,28100
"Kankakee-Bradley IL",2004,1522,1111,310,112,411,422,1331,107399,498,28100
"Kankakee-Bradley IL",2005,1503,1112,527,119,391,646,1032,108431,-5,28100
"Kankakee-Bradley IL",2006,1549,1027,872,117,522,989,1513,109944,2,28100
"Kankakee-Bradley IL",2007,1666,1042,838,107,624,945,1594,111538,25,28100
"Kankakee-Bradley IL",2008,1686,1073,210,109,613,319,986,112524,54,28100
"Kansas City MO-KS",2000,7027,3405,1572,1215,3622,2787,6389,1842814,-20,28140
"Kansas City MO-KS",2001,27842,15451,4294,4450,12391,8744,20893,1863707,-242,28140
"Kansas City MO-KS",2002,27970,15406,5848,4005,12564,9853,22204,1885911,-213,28140
"Kansas City MO-KS",2003,28983,15192,196,3079,13791,3275,16629,1902540,-437,28140
"Kansas City MO-KS",2004,28978,15231,1047,3617,13747,4664,17845,1920385,-566,28140
"Kansas City MO-KS",2005,28818,15564,1401,3491,13254,4892,17013,1937398,-1133,28140
"Kansas City MO-KS",2006,29647,15526,3798,3659,14121,7457,20930,1958328,-648,28140
"Kansas City MO-KS",2007,30447,15027,4529,3169,15420,7698,23152,1981480,34,28140
"Kansas City MO-KS",2008,30766,15031,1413,3260,15735,4673,20567,2002047,159,28140
"Kennewick-Pasco-Richland WA",2000,796,301,60,305,495,365,866,192691,6,28420
"Kennewick-Pasco-Richland WA",2001,3259,1298,698,1171,1961,1869,3654,196345,-176,28420
"Kennewick-Pasco-Richland WA",2002,3363,1297,3075,1099,2066,4174,6129,202474,-111,28420
"Kennewick-Pasco-Richland WA",2003,3434,1270,3069,962,2164,4031,6108,208582,-87,28420
"Kennewick-Pasco-Richland WA",2004,3511,1293,1810,874,2218,2684,4715,213297,-187,28420
"Kennewick-Pasco-Richland WA",2005,3588,1356,2105,911,2232,3016,5060,218357,-188,28420
"Kennewick-Pasco-Richland WA",2006,3741,1312,1292,905,2429,2197,4507,222864,-119,28420
"Kennewick-Pasco-Richland WA",2007,3949,1375,1646,840,2574,2486,5041,227905,-19,28420
"Kennewick-Pasco-Richland WA",2008,4024,1376,4399,842,2648,5241,7936,235841,47,28420
"Killeen-Temple-Fort Hood TX",2000,1515,522,-382,685,993,303,1300,332012,4,28660
"Killeen-Temple-Fort Hood TX",2001,6713,2058,-2650,152,4655,-2498,2422,334434,265,28660
"Killeen-Temple-Fort Hood TX",2002,6679,2158,2600,-1801,4521,799,5519,339953,199,28660
"Killeen-Temple-Fort Hood TX",2003,6778,2174,7316,-6062,4604,1254,6431,346384,573,28660
"Killeen-Temple-Fort Hood TX",2004,6431,2107,-5362,3153,4324,-2209,1891,348275,-224,28660
"Killeen-Temple-Fort Hood TX",2005,6348,2261,1876,71,4087,1947,5982,354257,-52,28660
"Killeen-Temple-Fort Hood TX",2006,7275,2290,-3038,1701,4985,-1337,3609,357866,-39,28660
"Killeen-Temple-Fort Hood TX",2007,6956,2246,8286,-176,4710,8110,12889,370755,69,28660
"Killeen-Temple-Fort Hood TX",2008,7016,2300,2867,642,4716,3509,8180,378935,-45,28660
"Kingsport-Bristol-Bristol TN-VA",2000,823,732,-170,26,91,-144,-48,298438,5,28700
"Kingsport-Bristol-Bristol TN-VA",2001,3353,3314,-130,136,39,6,-224,298214,-269,28700
"Kingsport-Bristol-Bristol TN-VA",2002,3183,3379,532,127,-196,659,204,298418,-259,28700
"Kingsport-Bristol-Bristol TN-VA",2003,3147,3497,1135,90,-350,1225,507,298925,-368,28700
"Kingsport-Bristol-Bristol TN-VA",2004,3200,3655,412,117,-455,529,-154,298771,-228,28700
"Kingsport-Bristol-Bristol TN-VA",2005,3147,3515,1860,109,-368,1969,1317,300088,-284,28700
"Kingsport-Bristol-Bristol TN-VA",2006,3308,3603,1601,115,-295,1716,1280,301368,-141,28700
"Kingsport-Bristol-Bristol TN-VA",2007,3277,3537,2013,103,-260,2116,1942,303310,86,28700
"Kingsport-Bristol-Bristol TN-VA",2008,3313,3588,1410,105,-275,1515,1379,304689,139,28700
"Kingston NY",2000,458,364,-17,49,94,32,132,177881,6,28740
"Kingston NY",2001,1746,1610,257,207,136,464,431,178312,-169,28740
"Kingston NY",2002,1805,1646,1231,191,159,1422,1448,179760,-133,28740
"Kingston NY",2003,1785,1562,377,155,223,532,522,180282,-233,28740
"Kingston NY",2004,1921,1520,299,178,401,477,752,181034,-126,28740
"Kingston NY",2005,1728,1569,230,175,159,405,387,181421,-177,28740
"Kingston NY",2006,1831,1436,-277,196,395,-81,231,181652,-83,28740
"Kingston NY",2007,1888,1508,-632,169,380,-463,-59,181593,24,28740
"Kingston NY",2008,1883,1536,-516,174,347,-342,77,181670,72,28740
"Knoxville TN",2000,1926,1420,763,179,506,942,1474,617550,26,28940
"Knoxville TN",2001,7651,6169,4087,672,1482,4759,7652,625202,1411,28940
"Knoxville TN",2002,7517,6156,4417,617,1361,5034,7497,632699,1102,28940
"Knoxville TN",2003,7689,6235,5194,509,1454,5703,8282,640981,1125,28940
"Knoxville TN",2004,7964,6509,5078,541,1455,5619,6891,647872,-183,28940
"Knoxville TN",2005,7971,6177,7516,538,1794,8054,9653,657525,-195,28940
"Knoxville TN",2006,8041,6090,9632,557,1951,10189,12005,669530,-135,28940
"Knoxville TN",2007,8487,6485,8616,490,2002,9106,11122,680652,14,28940
"Knoxville TN",2008,8636,6552,7813,503,2084,8316,10500,691152,100,28940
"Kokomo IN",2000,308,238,-93,13,70,-80,-12,101529,-2,29020
"Kokomo IN",2001,1396,1038,-448,65,358,-383,-116,101413,-91,29020
"Kokomo IN",2002,1364,1140,-578,59,224,-519,-377,101036,-82,29020
"Kokomo IN",2003,1422,1036,-460,49,386,-411,-142,100894,-117,29020
"Kokomo IN",2004,1377,1100,-521,51,277,-470,-274,100620,-81,29020
"Kokomo IN",2005,1293,1002,-324,53,291,-271,-70,100550,-90,29020
"Kokomo IN",2006,1310,962,-996,53,348,-943,-637,99913,-42,29020
"Kokomo IN",2007,1277,1039,-542,47,238,-495,-238,99675,19,29020
"Kokomo IN",2008,1315,1024,-746,46,291,-700,-371,99304,38,29020
"La Crosse WI-MN",2000,377,254,31,15,123,46,179,127017,10,29100
"La Crosse WI-MN",2001,1444,1152,330,80,292,410,583,127600,-119,29100
"La Crosse WI-MN",2002,1432,1074,284,75,358,359,592,128192,-125,29100
"La Crosse WI-MN",2003,1459,1077,170,58,382,228,425,128617,-185,29100
"La Crosse WI-MN",2004,1512,1069,-240,62,443,-178,173,128790,-92,29100
"La Crosse WI-MN",2005,1494,1058,103,62,436,165,489,129279,-112,29100
"La Crosse WI-MN",2006,1428,1075,168,64,353,232,523,129802,-62,29100
"La Crosse WI-MN",2007,1655,1046,587,51,609,638,1232,131034,-15,29100
"La Crosse WI-MN",2008,1576,1068,284,50,508,334,838,131872,-4,29100
"Lafayette IN",2000,525,303,-186,248,222,62,294,178835,10,29140
"Lafayette IN",2001,2353,1285,-582,998,1068,416,1315,180150,-169,29140
"Lafayette IN",2002,2246,1271,-1247,932,975,-315,511,180661,-149,29140
"Lafayette IN",2003,2283,1181,-609,822,1102,213,1094,181755,-221,29140
"Lafayette IN",2004,2453,1280,-1001,768,1173,-233,788,182543,-152,29140
"Lafayette IN",2005,2410,1261,530,793,1149,1323,2307,184850,-165,29140
"Lafayette IN",2006,2516,1348,1566,807,1168,2373,3438,188288,-103,29140
"Lafayette IN",2007,2535,1318,540,736,1217,1276,2471,190759,-22,29140
"Lafayette IN",2008,2628,1314,38,734,1314,772,2111,192870,25,29140
"Lafayette LA",2000,870,426,-335,67,444,-268,193,239099,17,29180
"Lafayette LA",2001,3565,1767,-1092,250,1798,-842,749,239848,-207,29180
"Lafayette LA",2002,3700,1840,333,234,1860,567,2192,242040,-235,29180
"Lafayette LA",2003,3604,1861,-232,187,1743,-45,1355,243395,-343,29180
"Lafayette LA",2004,3666,1850,118,207,1816,325,1986,245381,-155,29180
"Lafayette LA",2005,3754,1879,-16,205,1875,189,1833,247214,-231,29180
"Lafayette LA",2006,3723,1943,5305,212,1780,5517,7152,254366,-145,29180
"Lafayette LA",2007,3936,2013,-99,189,1923,90,1907,256273,-106,29180
"Lafayette LA",2008,3959,2012,795,194,1947,989,2800,259073,-136,29180
"Lake Charles LA",2000,712,411,-417,16,301,-401,-97,193468,3,29340
"Lake Charles LA",2001,2845,1785,-1663,91,1060,-1572,-659,192809,-147,29340
"Lake Charles LA",2002,2806,1800,-1168,85,1006,-1083,-234,192575,-157,29340
"Lake Charles LA",2003,2843,1772,-144,60,1071,-84,697,193272,-290,29340
"Lake Charles LA",2004,2796,1873,-428,76,923,-352,436,193708,-135,29340
"Lake Charles LA",2005,2830,1868,-598,72,962,-526,253,193961,-183,29340
"Lake Charles LA",2006,2714,2027,-3764,77,687,-3687,-3073,190888,-73,29340
"Lake Charles LA",2007,2978,1807,-136,68,1171,-68,992,191880,-111,29340
"Lake Charles LA",2008,2875,1841,-2,70,1034,68,976,192856,-126,29340
"Lake Havasu City-Kingman AZ",2000,445,455,1101,80,-10,1181,1148,156180,-23,29420
"Lake Havasu City-Kingman AZ",2001,1769,1932,3552,327,-163,3879,3642,159822,-74,29420
"Lake Havasu City-Kingman AZ",2002,1981,2032,5085,314,-51,5399,5329,165151,-19,29420
"Lake Havasu City-Kingman AZ",2003,2174,2249,5500,262,-75,5762,5820,170971,133,29420
"Lake Havasu City-Kingman AZ",2004,2309,2333,7402,246,-24,7648,7273,178244,-351,29420
"Lake Havasu City-Kingman AZ",2005,2300,2445,7651,259,-145,7910,7599,185843,-166,29420
"Lake Havasu City-Kingman AZ",2006,2332,2431,6672,258,-99,6930,6724,192567,-107,29420
"Lake Havasu City-Kingman AZ",2007,2562,2186,2602,235,376,2837,3306,195873,93,29420
"Lake Havasu City-Kingman AZ",2008,2579,2295,-185,237,284,52,408,196281,72,29420
"Lakeland-Winter Haven FL",2000,1600,1252,749,356,348,1105,1418,485342,-35,29460
"Lakeland-Winter Haven FL",2001,6874,5178,3323,1293,1696,4616,5908,491250,-404,29460
"Lakeland-Winter Haven FL",2002,6841,5263,4436,1215,1578,5651,6900,498150,-329,29460
"Lakeland-Winter Haven FL",2003,6919,5279,7034,1042,1640,8076,9542,507692,-174,29460
"Lakeland-Winter Haven FL",2004,7192,5495,10743,999,1697,11742,12758,520450,-681,29460
"Lakeland-Winter Haven FL",2005,7400,5631,15104,1039,1769,16143,17413,537863,-499,29460
"Lakeland-Winter Haven FL",2006,8062,5648,15648,1172,2414,16820,18923,556786,-311,29460
"Lakeland-Winter Haven FL",2007,8542,5647,11915,1039,2895,12954,16181,572967,332,29460
"Lakeland-Winter Haven FL",2008,8866,5822,3188,1043,3044,4231,7627,580594,352,29460
"Lancaster PA",2000,1702,1000,230,170,702,400,1118,471776,16,29540
"Lancaster PA",2001,6802,4283,8,526,2519,534,2561,474337,-492,29540
"Lancaster PA",2002,6634,4229,1182,490,2405,1672,3590,477927,-487,29540
"Lancaster PA",2003,6635,4242,1513,419,2393,1932,3668,481595,-657,29540
"Lancaster PA",2004,6840,4588,1467,424,2252,1891,3806,485401,-337,29540
"Lancaster PA",2005,6724,4508,1259,430,2216,1689,3483,488884,-422,29540
"Lancaster PA",2006,7037,4437,1482,608,2600,2090,4437,493321,-253,29540
"Lancaster PA",2007,7090,4337,1422,505,2753,1927,4634,497955,-46,29540
"Lancaster PA",2008,7203,4466,1118,507,2737,1625,4415,502370,53,29540
"Lansing-East Lansing MI",2000,1490,726,-450,336,764,-114,670,448491,20,29620
"Lansing-East Lansing MI",2001,5793,3123,-1362,1316,2670,-46,2229,450720,-395,29620
"Lansing-East Lansing MI",2002,5711,3127,-1275,1230,2584,-45,2197,452917,-342,29620
"Lansing-East Lansing MI",2003,5705,3146,-1681,1065,2559,-616,1551,454468,-392,29620
"Lansing-East Lansing MI",2004,5731,3253,-986,1018,2478,32,2159,456627,-351,29620
"Lansing-East Lansing MI",2005,5665,3355,-3243,1043,2310,-2200,-297,456330,-407,29620
"Lansing-East Lansing MI",2006,5608,3123,-4233,1060,2485,-3173,-880,455450,-192,29620
"Lansing-East Lansing MI",2007,5708,3179,-3968,959,2529,-3009,-379,455071,101,29620
"Lansing-East Lansing MI",2008,5852,3144,-4806,962,2708,-3844,-1036,454035,100,29620
"Laredo TX",2000,1335,216,-147,450,1119,303,1439,194556,17,29700
"Laredo TX",2001,5823,996,-1030,1772,4827,742,5391,199947,-178,29700
"Laredo TX",2002,5911,998,-1228,1672,4913,444,5188,205135,-169,29700
"Laredo TX",2003,5994,1037,-1005,1484,4957,479,5177,210312,-259,29700
"Laredo TX",2004,6033,1006,-611,1339,5027,728,5597,215909,-158,29700
"Laredo TX",2005,6000,948,-1000,1417,5052,417,5256,221165,-213,29700
"Laredo TX",2006,5919,1068,-864,1407,4851,543,5270,226435,-124,29700
"Laredo TX",2007,6051,1129,-1156,1278,4922,122,5042,231477,-2,29700
"Laredo TX",2008,6332,1183,-1037,1280,5149,243,5464,236941,72,29700
"Las Cruces NM",2000,691,244,-351,207,447,-144,310,174992,7,29740
"Las Cruces NM",2001,3015,1048,-1074,801,1967,-273,1544,176536,-150,29740
"Las Cruces NM",2002,3028,1157,-396,731,1871,335,2038,178574,-168,29740
"Las Cruces NM",2003,3165,1170,1262,605,1995,1867,3690,182264,-172,29740
"Las Cruces NM",2004,3164,1269,380,633,1895,1013,2781,185045,-127,29740
"Las Cruces NM",2005,3362,1236,1701,626,2126,2327,4285,189330,-168,29740
"Las Cruces NM",2006,3387,1211,1409,645,2176,2054,4125,193455,-105,29740
"Las Cruces NM",2007,3452,1309,1879,575,2143,2454,4593,198048,-4,29740
"Las Cruces NM",2008,3691,1366,599,584,2325,1183,3555,201603,47,29740
"Las Vegas-Paradise NV",2000,5333,2490,12458,2669,2843,15127,17705,1393240,-265,29820
"Las Vegas-Paradise NV",2001,22460,10615,41311,10190,11845,51501,62753,1455993,-593,29820
"Las Vegas-Paradise NV",2002,23309,11430,37491,9226,11879,46717,58135,1514128,-461,29820
"Las Vegas-Paradise NV",2003,24218,11435,35714,7376,12783,43090,56213,1570341,340,29820
"Las Vegas-Paradise NV",2004,25438,12038,53848,8120,13400,61968,72543,1642884,-2825,29820
"Las Vegas-Paradise NV",2005,26748,12289,39186,7980,14459,47166,60073,1702957,-1552,29820
"Las Vegas-Paradise NV",2006,28629,12590,44436,8249,16039,52685,67719,1770676,-1005,29820
"Las Vegas-Paradise NV",2007,29594,12954,32876,7245,16640,40121,56979,1827655,218,29820
"Las Vegas-Paradise NV",2008,30074,13270,14365,7372,16804,21737,38091,1865746,-450,29820
"Lawrence KS",2000,298,134,61,88,164,149,319,100281,6,29940
"Lawrence KS",2001,1166,531,218,353,635,571,2044,102325,838,29940
"Lawrence KS",2002,1221,570,480,329,651,809,2147,104472,687,29940
"Lawrence KS",2003,1245,524,203,270,721,473,1855,106327,661,29940
"Lawrence KS",2004,1231,537,433,275,694,708,2182,108509,780,29940
"Lawrence KS",2005,1229,573,52,278,656,330,3010,111519,2024,29940
"Lawrence KS",2006,1274,610,542,286,664,828,1040,112559,-452,29940
"Lawrence KS",2007,1285,557,-110,259,728,149,841,113400,-36,29940
"Lawrence KS",2008,1361,557,304,263,804,567,1348,114748,-23,29940
"Lawton OK",2000,482,206,-775,184,276,-591,-323,114675,-8,30020
"Lawton OK",2001,1886,824,-3427,-56,1062,-3483,-2451,112224,-30,30020
"Lawton OK",2002,1877,863,-466,-676,1014,-1142,-231,111993,-103,30020
"Lawton OK",2003,1870,870,-418,-1965,1000,-2383,-1526,110467,-143,30020
"Lawton OK",2004,1841,882,1424,895,959,2319,3156,113623,-122,30020
"Lawton OK",2005,2051,940,-2714,-74,1111,-2788,-1763,111860,-86,30020
"Lawton OK",2006,1886,917,-963,442,969,-521,396,112256,-52,30020
"Lawton OK",2007,2025,895,685,-136,1130,549,1675,113931,-4,30020
"Lawton OK",2008,2081,905,-3477,109,1176,-3368,-2159,111772,33,30020
"Lebanon PA",2000,362,291,-13,22,71,9,91,120417,11,30140
"Lebanon PA",2001,1434,1252,225,124,182,349,402,120819,-129,30140
"Lebanon PA",2002,1399,1254,351,111,145,462,490,121309,-117,30140
"Lebanon PA",2003,1493,1276,946,77,217,1023,1128,122437,-112,30140
"Lebanon PA",2004,1480,1331,1024,121,149,1145,1187,123624,-107,30140
"Lebanon PA",2005,1585,1366,1021,106,219,1127,1236,124860,-110,30140
"Lebanon PA",2006,1585,1384,1257,157,201,1414,1550,126410,-65,30140
"Lebanon PA",2007,1596,1338,1069,120,258,1189,1451,127861,4,30140
"Lebanon PA",2008,1637,1332,606,122,305,728,1073,128934,40,30140
"Lewiston ID-WA",2000,175,143,-46,6,32,-40,-7,57954,1,30300
"Lewiston ID-WA",2001,667,603,-527,29,64,-498,-478,57476,-44,30300
"Lewiston ID-WA",2002,700,595,97,26,105,123,165,57641,-63,30300
"Lewiston ID-WA",2003,697,640,538,12,57,550,558,58199,-49,30300
"Lewiston ID-WA",2004,765,643,295,21,122,316,391,58590,-47,30300
"Lewiston ID-WA",2005,693,617,318,19,76,337,371,58961,-42,30300
"Lewiston ID-WA",2006,697,615,513,22,82,535,584,59545,-33,30300
"Lewiston ID-WA",2007,734,655,314,13,79,327,360,59905,-46,30300
"Lewiston ID-WA",2008,768,653,407,16,115,423,490,60395,-48,30300
"Lewiston-Auburn ME",2000,291,241,-18,16,50,-2,53,103846,5,30340
"Lewiston-Auburn ME",2001,1187,1027,170,58,160,228,292,104138,-96,30340
"Lewiston-Auburn ME",2002,1244,1045,545,42,199,587,704,104842,-82,30340
"Lewiston-Auburn ME",2003,1275,1054,775,12,221,787,904,105746,-104,30340
"Lewiston-Auburn ME",2004,1303,1045,368,68,258,436,616,106362,-78,30340
"Lewiston-Auburn ME",2005,1330,1047,-25,51,283,26,222,106584,-87,30340
"Lewiston-Auburn ME",2006,1388,1030,-39,65,358,26,332,106916,-52,30340
"Lewiston-Auburn ME",2007,1433,1005,-682,42,428,-640,-215,106701,-3,30340
"Lewiston-Auburn ME",2008,1388,1019,-248,48,369,-200,176,106877,7,30340
"Lexington-Fayette KY",2000,1437,773,281,352,664,633,1320,409646,23,30460
"Lexington-Fayette KY",2001,5781,3178,343,1385,2603,1728,3959,413605,-372,30460
"Lexington-Fayette KY",2002,5641,3398,-126,1305,2243,1179,3089,416694,-333,30460
"Lexington-Fayette KY",2003,5745,3236,2196,1127,2509,3323,5352,422046,-480,30460
"Lexington-Fayette KY",2004,6099,3189,842,1057,2910,1899,4450,426496,-359,30460
"Lexington-Fayette KY",2005,6018,3140,2188,1101,2878,3289,5787,432283,-380,30460
"Lexington-Fayette KY",2006,6245,3293,3745,1111,2952,4856,7576,439859,-232,30460
"Lexington-Fayette KY",2007,6395,3337,2235,996,3058,3231,6250,446109,-39,30460
"Lexington-Fayette KY",2008,6416,3371,3207,1007,3045,4214,7315,453424,56,30460
"Lima OH",2000,364,274,2,1,90,3,104,108577,11,30620
"Lima OH",2001,1565,1123,-765,30,442,-735,-381,108196,-88,30620
"Lima OH",2002,1469,1110,-652,29,359,-623,-349,107847,-85,30620
"Lima OH",2003,1480,1089,-1691,21,391,-1670,-1313,106534,-34,30620
"Lima OH",2004,1491,1053,-1107,28,438,-1079,-741,105793,-100,30620
"Lima OH",2005,1480,1021,-633,25,459,-608,-243,105550,-94,30620
"Lima OH",2006,1412,978,-766,30,434,-736,-348,105202,-46,30620
"Lima OH",2007,1438,1082,-456,22,356,-434,-69,105133,9,30620
"Lima OH",2008,1482,1057,-459,22,425,-437,35,105168,47,30620
"Lincoln NE",2000,1012,396,228,265,616,493,1122,267909,13,30700
"Lincoln NE",2001,3903,1830,246,1009,2073,1255,3059,270968,-269,30700
"Lincoln NE",2002,3898,1877,906,920,2021,1826,3609,274577,-238,30700
"Lincoln NE",2003,4165,1901,1267,787,2264,2054,3994,278571,-324,30700
"Lincoln NE",2004,4278,1885,-513,801,2393,288,2476,281047,-205,30700
"Lincoln NE",2005,4318,1838,545,802,2480,1347,3553,284600,-274,30700
"Lincoln NE",2006,4329,1955,122,818,2374,940,3171,287771,-143,30700
"Lincoln NE",2007,4375,1813,162,732,2562,894,3477,291248,21,30700
"Lincoln NE",2008,4631,1891,649,738,2740,1387,4238,295486,111,30700
"Little Rock-North Little Rock-Conway AR",2000,2197,1202,402,207,995,609,1614,612128,10,30780
"Little Rock-North Little Rock-Conway AR",2001,8973,5447,1180,616,3526,1796,5196,617324,-126,30780
"Little Rock-North Little Rock-Conway AR",2002,8921,5322,1784,329,3599,2113,5538,622862,-174,30780
"Little Rock-North Little Rock-Conway AR",2003,9059,5370,3189,-199,3689,2990,6490,629352,-189,30780
"Little Rock-North Little Rock-Conway AR",2004,9249,5744,3398,800,3505,4198,7559,636911,-144,30780
"Little Rock-North Little Rock-Conway AR",2005,9392,5539,4225,429,3853,4654,8352,645263,-155,30780
"Little Rock-North Little Rock-Conway AR",2006,9530,5618,6835,667,3912,7502,11350,656613,-64,30780
"Little Rock-North Little Rock-Conway AR",2007,10204,5528,3813,421,4676,4234,9044,665657,134,30780
"Little Rock-North Little Rock-Conway AR",2008,10114,5449,4110,478,4665,4588,9412,675069,159,30780
"Logan UT-ID",2000,622,138,-111,106,484,-5,482,103202,3,30860
"Logan UT-ID",2001,2389,515,-1213,423,1874,-790,2028,105230,944,30860
"Logan UT-ID",2002,2504,491,479,400,2013,879,3694,108924,802,30860
"Logan UT-ID",2003,2528,529,-707,347,1999,-360,2923,111847,1284,30860
"Logan UT-ID",2004,2708,542,-464,327,2166,-137,2314,114161,285,30860
"Logan UT-ID",2005,2680,457,-821,334,2223,-487,2443,116604,707,30860
"Logan UT-ID",2006,2631,503,-1828,334,2128,-1494,1798,118402,1164,30860
"Logan UT-ID",2007,2822,505,154,306,2317,460,2751,121153,-26,30860
"Logan UT-ID",2008,3074,529,1059,306,2545,1365,3917,125070,7,30860
"Longview TX",2000,686,504,-327,89,182,-238,-60,193982,-4,30980
"Longview TX",2001,2828,2220,-195,421,608,226,640,194622,-194,30980
"Longview TX",2002,2940,2171,686,407,769,1093,1688,196310,-174,30980
"Longview TX",2003,2893,2083,111,342,810,453,1002,197312,-261,30980
"Longview TX",2004,2966,2132,6,312,834,318,1004,198316,-148,30980
"Longview TX",2005,2998,2171,93,324,827,417,1061,199377,-183,30980
"Longview TX",2006,3128,2164,772,320,964,1092,1955,201332,-101,30980
"Longview TX",2007,3184,2023,428,296,1161,724,1873,203205,-12,30980
"Longview TX",2008,3128,2117,186,296,1011,482,1541,204746,48,30980
"Longview WA",2000,336,239,-77,30,97,-47,51,92999,1,31020
"Longview WA",2001,1247,901,206,149,346,355,599,93598,-102,31020
"Longview WA",2002,1253,927,304,138,326,442,672,94270,-96,31020
"Longview WA",2003,1152,959,-82,107,193,25,85,94355,-133,31020
"Longview WA",2004,1199,969,700,120,230,820,973,95328,-77,31020
"Longview WA",2005,1261,1009,613,117,252,730,903,96231,-79,31020
"Longview WA",2006,1283,1020,2125,121,263,2246,2454,98685,-55,31020
"Longview WA",2007,1327,989,1096,105,338,1201,1531,100216,-8,31020
"Longview WA",2008,1362,970,532,108,392,640,1038,101254,6,31020
"Los Angeles-Long Beach-Santa Ana CA",2000,49398,17873,-27528,31086,31525,3558,35406,12401030,323,31100
"Los Angeles-Long Beach-Santa Ana CA",2001,201843,76689,-104034,124689,125154,20655,135568,12536598,-10241,31100
"Los Angeles-Long Beach-Santa Ana CA",2002,196949,76989,-109505,117720,119960,8215,118908,12655506,-9267,31100
"Los Angeles-Long Beach-Santa Ana CA",2003,197857,76591,-119876,103045,121266,-16831,93027,12748533,-11408,31100
"Los Angeles-Long Beach-Santa Ana CA",2004,196470,78852,-140949,93827,117618,-47122,58245,12806778,-12251,31100
"Los Angeles-Long Beach-Santa Ana CA",2005,196418,75375,-200728,98800,121043,-101928,8567,12815345,-10548,31100
"Los Angeles-Long Beach-Santa Ana CA",2006,194688,77969,-227993,98254,116719,-129739,-18367,12796978,-5347,31100
"Los Angeles-Long Beach-Santa Ana CA",2007,194308,78081,-221144,89508,116227,-131636,-12366,12784612,3043,31100
"Los Angeles-Long Beach-Santa Ana CA",2008,192833,79053,-115037,89674,113780,-25363,88196,12872808,-221,31100
"Louisville/Jefferson County KY-IN",2000,3943,2503,683,509,1440,1192,2646,1165060,14,31140
"Louisville/Jefferson County KY-IN",2001,15995,11143,703,1830,4852,2533,7025,1172085,-360,31140
"Louisville/Jefferson County KY-IN",2002,15808,11105,1508,1634,4703,3142,7455,1179540,-390,31140
"Louisville/Jefferson County KY-IN",2003,15866,10965,3585,1186,4901,4771,8931,1188471,-741,31140
"Louisville/Jefferson County KY-IN",2004,16138,11036,3399,1483,5102,4882,9664,1198135,-320,31140
"Louisville/Jefferson County KY-IN",2005,16017,10761,2816,1415,5256,4231,9080,1207215,-407,31140
"Louisville/Jefferson County KY-IN",2006,16322,10790,5274,1505,5532,6779,11749,1218964,-562,31140
"Louisville/Jefferson County KY-IN",2007,16775,11121,6238,1264,5654,7502,13340,1232304,184,31140
"Louisville/Jefferson County KY-IN",2008,16760,11297,5099,1307,5463,6406,12392,1244696,523,31140
"Lubbock TX",2000,934,448,-150,69,486,-81,421,250121,16,31180
"Lubbock TX",2001,3920,1980,1032,294,1940,1326,3242,253363,-24,31180
"Lubbock TX",2002,4062,2128,189,274,1934,463,2314,255677,-83,31180
"Lubbock TX",2003,4153,2017,1082,236,2136,1318,3378,259055,-76,31180
"Lubbock TX",2004,4174,2060,-505,234,2114,-271,1908,260963,65,31180
"Lubbock TX",2005,4118,2124,-575,239,1994,-336,1633,262596,-25,31180
"Lubbock TX",2006,4090,2116,1078,242,1974,1320,3292,265888,-2,31180
"Lubbock TX",2007,4359,2102,-277,215,2257,-62,2197,268085,2,31180
"Lubbock TX",2008,4439,2137,-87,217,2302,130,2525,270610,93,31180
"Lynchburg VA",2000,663,548,171,35,115,206,301,228917,-20,31340
"Lynchburg VA",2001,2713,2262,-219,203,451,-16,206,229123,-229,31340
"Lynchburg VA",2002,2546,2307,94,196,239,290,309,229432,-220,31340
"Lynchburg VA",2003,2580,2257,1452,164,323,1616,1699,231131,-240,31340
"Lynchburg VA",2004,2610,2360,1297,171,250,1468,1532,232663,-186,31340
"Lynchburg VA",2005,2555,2180,2957,171,375,3128,3306,235969,-197,31340
"Lynchburg VA",2006,2732,2298,3593,182,434,3775,4085,240054,-124,31340
"Lynchburg VA",2007,2780,2321,3029,155,459,3184,3598,243652,-45,31340
"Lynchburg VA",2008,2934,2331,1508,153,603,1661,2157,245809,-107,31340
"Macon GA",2000,774,517,-309,49,257,-260,0,222385,3,31420
"Macon GA",2001,3386,2283,-715,186,1103,-529,386,222771,-188,31420
"Macon GA",2002,3272,2253,624,165,1019,789,1627,224398,-181,31420
"Macon GA",2003,3341,2262,285,107,1079,392,1284,225682,-187,31420
"Macon GA",2004,3294,2239,274,158,1055,432,1304,226986,-183,31420
"Macon GA",2005,3385,2315,-423,143,1070,-280,596,227582,-194,31420
"Macon GA",2006,3321,2230,65,161,1091,226,1205,228787,-112,31420
"Macon GA",2007,3478,2290,-299,129,1188,-170,1044,229831,26,31420
"Macon GA",2008,3392,2295,-364,140,1097,-224,946,230777,73,31420
"Madera CA",2000,540,200,-113,226,340,113,463,123572,10,31460
"Madera CA",2001,2144,891,-127,901,1253,774,1902,125474,-125,31460
"Madera CA",2002,2134,940,542,849,1194,1391,2475,127949,-110,31460
"Madera CA",2003,2229,924,2235,736,1305,2971,4251,132200,-25,31460
"Madera CA",2004,2318,931,2700,671,1387,3371,4583,136783,-175,31460
"Madera CA",2005,2375,930,1231,711,1445,1942,3266,140049,-121,31460
"Madera CA",2006,2460,928,1123,706,1532,1829,3282,143331,-79,31460
"Madera CA",2007,2649,979,61,642,1670,703,2323,145654,-50,31460
"Madera CA",2008,2688,924,336,645,1764,981,2679,148333,-66,31460
"Madison WI",2000,1618,753,846,506,865,1352,2247,504020,30,31540
"Madison WI",2001,6393,3349,3181,1913,3044,5094,7689,511709,-449,31540
"Madison WI",2002,6541,3380,3202,1782,3161,4984,7730,519439,-415,31540
"Madison WI",2003,6560,3393,2724,1531,3167,4255,6807,526246,-615,31540
"Madison WI",2004,6876,3381,2576,1445,3495,4021,7101,533347,-415,31540
"Madison WI",2005,7083,3343,1775,1500,3740,3275,6518,539865,-497,31540
"Madison WI",2006,6954,3212,1623,1526,3742,3149,6615,546480,-276,31540
"Madison WI",2007,7246,3333,2480,1369,3913,3849,7787,554267,25,31540
"Madison WI",2008,7356,3355,1680,1371,4001,3051,7238,561505,186,31540
"Manchester-Nashua NH",2000,1324,654,458,360,670,818,1518,382361,30,31700
"Manchester-Nashua NH",2001,5038,2784,2473,1296,2254,3769,5703,388064,-320,31700
"Manchester-Nashua NH",2002,5006,2751,-461,1195,2255,734,2618,390682,-371,31700
"Manchester-Nashua NH",2003,4932,2676,-770,1025,2256,255,1959,392641,-552,31700
"Manchester-Nashua NH",2004,5008,2775,415,982,2233,1397,3379,396020,-251,31700
"Manchester-Nashua NH",2005,5286,2821,-929,1020,2465,91,2173,398193,-383,31700
"Manchester-Nashua NH",2006,5245,2880,-1450,1076,2365,-374,1809,400002,-182,31700
"Manchester-Nashua NH",2007,4975,2922,-2045,964,2053,-1081,1058,401060,86,31700
"Manchester-Nashua NH",2008,4845,2802,-2118,968,2043,-1150,982,402042,89,31700
"Mansfield OH",2000,385,284,-172,14,101,-158,-53,128799,4,31900
"Mansfield OH",2001,1673,1193,-1229,51,480,-1178,-793,128006,-95,31900
"Mansfield OH",2002,1546,1229,-186,41,317,-145,53,128059,-119,31900
"Mansfield OH",2003,1562,1193,-470,21,369,-449,-242,127817,-162,31900
"Mansfield OH",2004,1594,1257,-657,53,337,-604,-366,127451,-99,31900
"Mansfield OH",2005,1529,1302,-671,41,227,-630,-516,126935,-113,31900
"Mansfield OH",2006,1660,1187,-1102,49,473,-1053,-637,126298,-57,31900
"Mansfield OH",2007,1636,1263,-847,38,373,-809,-430,125868,6,31900
"Mansfield OH",2008,1623,1227,-1301,39,396,-1262,-869,124999,-3,31900
"McAllen-Edinburg-Mission TX",2000,3567,659,-221,1290,2908,1069,4035,573498,58,32580
"McAllen-Edinburg-Mission TX",2001,15276,2849,-1672,5128,12427,3456,15338,588836,-545,32580
"McAllen-Edinburg-Mission TX",2002,15201,3073,2728,4847,12128,7575,19170,608006,-533,32580
"McAllen-Edinburg-Mission TX",2003,16042,2978,3426,4253,13064,7679,20037,628043,-706,32580
"McAllen-Edinburg-Mission TX",2004,16425,3144,3145,3836,13281,6981,19728,647771,-534,32580
"McAllen-Edinburg-Mission TX",2005,16653,3193,2522,4055,13460,6577,19383,667154,-654,32580
"McAllen-Edinburg-Mission TX",2006,17157,3225,1311,4025,13932,5336,18880,686034,-388,32580
"McAllen-Edinburg-Mission TX",2007,17379,3469,1956,3671,13910,5627,19444,705478,-93,32580
"McAllen-Edinburg-Mission TX",2008,18125,3557,2727,3675,14568,6402,21126,726604,156,32580
"Medford OR",2000,530,468,384,68,62,452,513,181788,-1,32780
"Medford OR",2001,2067,1891,1730,272,176,2002,2009,183797,-169,32780
"Medford OR",2002,2106,1887,2457,254,219,2711,2795,186592,-135,32780
"Medford OR",2003,2104,2017,2736,218,87,2954,2941,189533,-100,32780
"Medford OR",2004,2140,1941,2042,218,199,2260,2283,191816,-176,32780
"Medford OR",2005,2174,1841,2054,221,333,2275,2452,194268,-156,32780
"Medford OR",2006,2228,2044,1935,224,184,2159,2234,196502,-109,32780
"Medford OR",2007,2394,1916,1880,204,478,2084,2501,199003,-61,32780
"Medford OR",2008,2436,1924,1469,205,512,1674,2135,201138,-51,32780
"Memphis TN-MS-AR",2000,4749,2582,257,613,2167,870,3050,1208246,13,32820
"Memphis TN-MS-AR",2001,19500,10812,-3057,2040,8688,-1017,6796,1215042,-875,32820
"Memphis TN-MS-AR",2002,19187,10697,-934,1783,8490,849,8474,1223516,-865,32820
"Memphis TN-MS-AR",2003,19026,10618,1056,1308,8408,2364,9744,1233260,-1028,32820
"Memphis TN-MS-AR",2004,19361,10608,-202,1646,8753,1444,9102,1242362,-1095,32820
"Memphis TN-MS-AR",2005,19419,10677,1122,1571,8742,2693,10423,1252785,-1012,32820
"Memphis TN-MS-AR",2006,20091,10554,6847,1660,9537,8507,17478,1270263,-566,32820
"Memphis TN-MS-AR",2007,20521,10521,-2718,1406,10000,-1312,8857,1279120,169,32820
"Memphis TN-MS-AR",2008,20329,10828,-4547,1452,9501,-3095,6612,1285732,206,32820
"Merced CA",2000,910,291,17,355,619,372,1006,211552,15,32900
"Merced CA",2001,3938,1377,2134,1378,2561,3512,5905,217457,-168,32900
"Merced CA",2002,3993,1447,2138,1307,2546,3445,5839,223296,-152,32900
"Merced CA",2003,4243,1503,1786,1142,2740,2928,5467,228763,-201,32900
"Merced CA",2004,4224,1447,1086,1035,2777,2121,4708,233471,-190,32900
"Merced CA",2005,4412,1458,734,1091,2954,1825,4563,238034,-216,32900
"Merced CA",2006,4565,1472,-835,1085,3093,250,3220,241254,-123,32900
"Merced CA",2007,4757,1482,-1290,979,3275,-311,2964,244218,0,32900
"Merced CA",2008,4766,1575,-2348,981,3191,-1367,1899,246117,75,32900
"Miami-Fort Lauderdale-Pompano Beach FL",2000,15985,11336,-2249,16277,4649,14028,18526,5026518,-151,33100
"Miami-Fort Lauderdale-Pompano Beach FL",2001,68396,48376,-3665,64038,20020,60373,82066,5108584,1673,33100
"Miami-Fort Lauderdale-Pompano Beach FL",2002,68410,48119,-1766,60445,20291,58679,80147,5188731,1177,33100
"Miami-Fort Lauderdale-Pompano Beach FL",2003,69080,48051,-20134,53088,21029,32954,55016,5243747,1033,33100
"Miami-Fort Lauderdale-Pompano Beach FL",2004,69694,47791,-3199,48357,21903,45158,67508,5311255,447,33100
"Miami-Fort Lauderdale-Pompano Beach FL",2005,70298,47441,-9923,50887,22857,40964,64155,5375410,334,33100
"Miami-Fort Lauderdale-Pompano Beach FL",2006,71959,47507,-50595,51971,24452,1376,26924,5402334,1096,33100
"Miami-Fort Lauderdale-Pompano Beach FL",2007,70755,47896,-84268,47144,22859,-37124,-10216,5392118,4049,33100
"Miami-Fort Lauderdale-Pompano Beach FL",2008,68728,48975,-46997,47206,19753,209,22654,5414772,2692,33100
"Michigan City-La Porte IN",2000,369,257,-95,28,112,-67,52,110158,7,33140
"Michigan City-La Porte IN",2001,1442,1072,-474,95,370,-379,-109,110049,-100,33140
"Michigan City-La Porte IN",2002,1386,1013,-1004,89,373,-915,-625,109424,-83,33140
"Michigan City-La Porte IN",2003,1305,1046,-922,79,259,-843,-681,108743,-97,33140
"Michigan City-La Porte IN",2004,1351,1067,-440,77,284,-363,-162,108581,-83,33140
"Michigan City-La Porte IN",2005,1326,1048,314,79,278,393,564,109145,-107,33140
"Michigan City-La Porte IN",2006,1382,1076,-316,81,306,-235,22,109167,-49,33140
"Michigan City-La Porte IN",2007,1354,1052,703,72,302,775,1107,110274,30,33140
"Michigan City-La Porte IN",2008,1366,1052,182,72,314,254,614,110888,46,33140
"Midland TX",2000,461,222,-804,42,239,-762,-534,115475,-11,33260
"Midland TX",2001,1811,883,-730,185,928,-545,288,115763,-95,33260
"Midland TX",2002,1830,947,223,176,883,399,1173,116936,-109,33260
"Midland TX",2003,1856,880,45,155,976,200,1005,117941,-171,33260
"Midland TX",2004,1892,1000,241,157,892,398,1204,119145,-86,33260
"Midland TX",2005,1957,869,221,160,1088,381,1356,120501,-113,33260
"Midland TX",2006,1997,896,1735,162,1101,1897,2932,123433,-66,33260
"Midland TX",2007,2145,933,1455,149,1212,1604,2826,126259,10,33260
"Midland TX",2008,2214,962,1834,151,1252,1985,3235,129494,-2,33260
"Milwaukee-Waukesha-West Allis WI",2000,5444,3078,-1781,965,2366,-816,1518,1502261,-32,33340
"Milwaukee-Waukesha-West Allis WI",2001,21628,13313,-8619,3563,8315,-5056,8558,1510819,5299,33340
"Milwaukee-Waukesha-West Allis WI",2002,21266,13116,-7139,3334,8150,-3805,8499,1519318,4154,33340
"Milwaukee-Waukesha-West Allis WI",2003,21178,13021,-7866,2892,8157,-4974,7093,1526411,3910,33340
"Milwaukee-Waukesha-West Allis WI",2004,21649,13182,-10040,2679,8467,-7361,5345,1531756,4239,33340
"Milwaukee-Waukesha-West Allis WI",2005,21123,12768,-12903,2819,8355,-10084,2406,1534162,4135,33340
"Milwaukee-Waukesha-West Allis WI",2006,21522,12845,-11551,3017,8677,-8534,4559,1538721,4416,33340
"Milwaukee-Waukesha-West Allis WI",2007,22124,12209,-7844,2701,9915,-5143,4657,1543378,-115,33340
"Milwaukee-Waukesha-West Allis WI",2008,22117,12444,-6443,2704,9673,-3739,5930,1549308,-4,33340
"Minneapolis-St. Paul-Bloomington MN-WI",2000,11053,4354,3152,2824,6699,5976,12690,2981508,15,33460
"Minneapolis-St. Paul-Bloomington MN-WI",2001,44641,18992,7571,11188,25649,18759,42238,3023746,-2170,33460
"Minneapolis-St. Paul-Bloomington MN-WI",2002,43783,19151,-4601,10457,24632,5856,28874,3052620,-1614,33460
"Minneapolis-St. Paul-Bloomington MN-WI",2003,45251,18796,-9151,9046,26455,-105,24794,3077414,-1556,33460
"Minneapolis-St. Paul-Bloomington MN-WI",2004,46167,19020,-4184,8373,27147,4189,28207,3105621,-3129,33460
"Minneapolis-St. Paul-Bloomington MN-WI",2005,46085,19026,-7224,8755,27059,1531,26011,3131632,-2579,33460
"Minneapolis-St. Paul-Bloomington MN-WI",2006,46583,18603,-2764,8820,27980,6056,32548,3164180,-1488,33460
"Minneapolis-St. Paul-Bloomington MN-WI",2007,46896,19184,-1965,7978,27712,6013,33440,3197620,-285,33460
"Minneapolis-St. Paul-Bloomington MN-WI",2008,47115,19293,-3440,7984,27822,4544,32258,3229878,-108,33460
"Missoula MT",2000,341,150,153,18,191,171,368,96167,6,33540
"Missoula MT",2001,1116,658,771,83,458,854,1231,97398,-81,33540
"Missoula MT",2002,1127,666,1054,78,461,1132,1527,98925,-66,33540
"Missoula MT",2003,1093,694,579,56,399,635,929,99854,-105,33540
"Missoula MT",2004,1196,711,479,65,485,544,956,100810,-73,33540
"Missoula MT",2005,1172,693,877,63,479,940,1330,102140,-89,33540
"Missoula MT",2006,1220,666,1264,67,554,1331,1833,103973,-52,33540
"Missoula MT",2007,1303,704,1003,60,599,1063,1665,105638,3,33540
"Missoula MT",2008,1367,698,919,62,669,981,1682,107320,32,33540
"Mobile AL",2000,1502,938,-521,120,564,-401,185,400028,22,33660
"Mobile AL",2001,6090,3899,-2360,480,2191,-1880,-31,399997,-342,33660
"Mobile AL",2002,5963,3917,-3954,404,2046,-3550,-1769,398228,-265,33660
"Mobile AL",2003,5752,3888,-2488,260,1864,-2228,-786,397442,-422,33660
"Mobile AL",2004,5780,4038,-2134,435,1742,-1699,-268,397174,-311,33660
"Mobile AL",2005,5792,3929,-1125,370,1863,-755,735,397909,-373,33660
"Mobile AL",2006,5901,3988,1579,423,1913,2002,3720,401629,-195,33660
"Mobile AL",2007,6114,3870,29,346,2244,375,2468,404097,-151,33660
"Mobile AL",2008,6044,3926,-111,356,2118,245,2212,406309,-151,33660
"Modesto CA",2000,1788,776,1111,580,1012,1691,2710,449708,7,33700
"Modesto CA",2001,7396,3575,8443,2273,3821,10716,14232,463940,-305,33700
"Modesto CA",2002,7790,3672,7574,2138,4118,9712,13598,477538,-232,33700
"Modesto CA",2003,8089,3741,3800,1879,4348,5679,9566,487104,-461,33700
"Modesto CA",2004,7880,3622,-316,1718,4258,1402,5338,492442,-322,33700
"Modesto CA",2005,8348,3521,1221,1804,4827,3025,7380,499822,-472,33700
"Modesto CA",2006,8431,3696,-897,1796,4735,899,5383,505205,-251,33700
"Modesto CA",2007,8864,3789,-2911,1643,5075,-1268,3863,509068,56,33700
"Modesto CA",2008,8841,3767,-5329,1647,5074,-3682,1626,510694,234,33700
"Monroe LA",2000,597,391,-233,12,206,-221,-6,170047,9,33740
"Monroe LA",2001,2709,1683,-1589,61,1026,-1528,-643,169404,-141,33740
"Monroe LA",2002,2551,1577,-300,54,974,-246,566,169970,-162,33740
"Monroe LA",2003,2525,1617,-17,30,908,13,672,170642,-249,33740
"Monroe LA",2004,2662,1571,-549,57,1091,-492,477,171119,-122,33740
"Monroe LA",2005,2647,1638,-1123,49,1009,-1074,-220,170899,-155,33740
"Monroe LA",2006,2575,1754,730,56,821,786,1522,172421,-85,33740
"Monroe LA",2007,2774,1671,-1374,43,1103,-1331,-190,172231,38,33740
"Monroe LA",2008,2709,1658,-624,46,1051,-578,512,172743,39,33740
"Monroe MI",2000,458,314,289,22,144,311,460,146405,5,33780
"Monroe MI",2001,1757,1203,704,106,554,810,1226,147631,-138,33780
"Monroe MI",2002,1666,1203,510,102,463,612,935,148566,-140,33780
"Monroe MI",2003,1718,1151,616,85,567,701,1083,149649,-185,33780
"Monroe MI",2004,1773,1172,822,91,601,913,1392,151041,-122,33780
"Monroe MI",2005,1702,1223,770,91,479,861,1201,152242,-139,33780
"Monroe MI",2006,1782,1234,338,96,548,434,908,153150,-74,33780
"Monroe MI",2007,1802,1258,-467,85,544,-382,181,153331,19,33780
"Monroe MI",2008,1855,1226,-1180,85,629,-1095,-382,152949,84,33780
"Montgomery AL",2000,1261,682,-181,77,579,-104,483,347005,8,33860
"Montgomery AL",2001,5461,3046,-989,177,2415,-812,1331,348336,-272,33860
"Montgomery AL",2002,5090,3103,330,-38,1987,292,2005,350341,-274,33860
"Montgomery AL",2003,4958,3191,294,-409,1767,-115,1316,351657,-336,33860
"Montgomery AL",2004,4961,3219,-195,374,1742,179,1593,353250,-328,33860
"Montgomery AL",2005,5121,3298,1307,59,1823,1366,2860,356110,-329,33860
"Montgomery AL",2006,5209,3290,4346,256,1919,4602,6337,362447,-184,33860
"Montgomery AL",2007,5370,3254,1255,93,2116,1348,3529,365976,65,33860
"Montgomery AL",2008,5425,3301,-2433,129,2124,-2304,-52,365924,128,33860
"Morgantown WV",2000,289,247,-113,64,42,-49,0,111201,7,34060
"Morgantown WV",2001,1166,1013,444,240,153,684,739,111940,-98,34060
"Morgantown WV",2002,1144,957,526,224,187,750,840,112780,-97,34060
"Morgantown WV",2003,1228,980,936,194,248,1130,1289,114069,-89,34060
"Morgantown WV",2004,1305,923,306,189,382,495,795,114864,-82,34060
"Morgantown WV",2005,1171,968,759,198,203,957,1054,115918,-106,34060
"Morgantown WV",2006,1226,901,372,202,325,574,841,116759,-58,34060
"Morgantown WV",2007,1297,942,267,174,355,441,788,117547,-8,34060
"Morgantown WV",2008,1319,938,403,173,381,576,959,118506,2,34060
"Morristown TN",2000,420,306,274,92,114,366,481,123562,1,34100
"Morristown TN",2001,1627,1203,474,406,424,880,1189,124751,-115,34100
"Morristown TN",2002,1597,1307,-198,381,290,183,389,125140,-84,34100
"Morristown TN",2003,1623,1332,1073,329,291,1402,1580,126720,-113,34100
"Morristown TN",2004,1584,1338,882,306,246,1188,1324,128044,-110,34100
"Morristown TN",2005,1656,1361,1254,322,295,1576,1754,129798,-117,34100
"Morristown TN",2006,1732,1293,1423,324,439,1747,2117,131915,-69,34100
"Morristown TN",2007,1719,1390,1667,286,329,1953,2332,134247,50,34100
"Morristown TN",2008,1741,1401,974,289,340,1263,1667,135914,64,34100
"Mount Vernon-Anacortes WA",2000,360,235,248,119,125,367,491,103466,-1,34580
"Mount Vernon-Anacortes WA",2001,1435,942,555,404,493,959,1362,104828,-90,34580
"Mount Vernon-Anacortes WA",2002,1400,962,591,365,438,956,1298,106126,-96,34580
"Mount Vernon-Anacortes WA",2003,1325,1040,1584,261,285,1845,2079,108205,-51,34580
"Mount Vernon-Anacortes WA",2004,1395,1034,1276,337,361,1613,1871,110076,-103,34580
"Mount Vernon-Anacortes WA",2005,1467,965,1153,324,502,1477,1887,111963,-92,34580
"Mount Vernon-Anacortes WA",2006,1440,1059,1515,342,381,1857,2173,114136,-65,34580
"Mount Vernon-Anacortes WA",2007,1558,1042,1001,280,516,1281,1762,115898,-35,34580
"Mount Vernon-Anacortes WA",2008,1579,1059,1331,292,520,1623,2102,118000,-41,34580
"Muncie IN",2000,344,288,-134,35,56,-99,-35,118734,8,34620
"Muncie IN",2001,1417,1160,952,134,257,1086,1253,119987,-90,34620
"Muncie IN",2002,1320,1129,-846,123,191,-723,-632,119355,-100,34620
"Muncie IN",2003,1326,1228,-464,99,98,-365,-403,118952,-136,34620
"Muncie IN",2004,1345,1167,-1418,104,178,-1314,-1254,117698,-118,34620
"Muncie IN",2005,1286,1120,-1267,104,166,-1163,-1098,116600,-101,34620
"Muncie IN",2006,1282,1223,-1226,109,59,-1117,-1102,115498,-44,34620
"Muncie IN",2007,1279,1186,-550,96,93,-454,-331,115167,30,34620
"Muncie IN",2008,1353,1157,-827,96,196,-731,-482,114685,53,34620
"Muskegon-Norton Shores MI",2000,571,349,32,24,222,56,286,170486,8,34740
"Muskegon-Norton Shores MI",2001,2435,1588,-41,116,847,75,753,171239,-169,34740
"Muskegon-Norton Shores MI",2002,2327,1608,-97,106,719,9,564,171803,-164,34740
"Muskegon-Norton Shores MI",2003,2312,1575,105,90,737,195,676,172479,-256,34740
"Muskegon-Norton Shores MI",2004,2426,1619,-199,89,807,-110,581,173060,-116,34740
"Muskegon-Norton Shores MI",2005,2338,1624,230,89,714,319,865,173925,-168,34740
"Muskegon-Norton Shores MI",2006,2370,1642,-621,90,728,-531,120,174045,-77,34740
"Muskegon-Norton Shores MI",2007,2385,1535,-895,79,850,-816,63,174108,29,34740
"Muskegon-Norton Shores MI",2008,2456,1534,-807,79,922,-728,236,174344,42,34740
"Myrtle Beach-North Myrtle Beach-Conway SC",2000,629,410,1148,111,219,1259,1460,198120,-18,34820
"Myrtle Beach-North Myrtle Beach-Conway SC",2001,2518,1916,2794,438,602,3232,3713,201833,-121,34820
"Myrtle Beach-North Myrtle Beach-Conway SC",2002,2596,1909,3282,408,687,3690,4277,206110,-100,34820
"Myrtle Beach-North Myrtle Beach-Conway SC",2003,2608,1978,3754,361,630,4115,4730,210840,-15,34820
"Myrtle Beach-North Myrtle Beach-Conway SC",2004,2753,1974,6276,339,779,6615,7050,217890,-344,34820
"Myrtle Beach-North Myrtle Beach-Conway SC",2005,2833,2105,9422,354,728,9776,10364,228254,-140,34820
"Myrtle Beach-North Myrtle Beach-Conway SC",2006,3092,2258,10203,364,834,10567,11242,239496,-159,34820
"Myrtle Beach-North Myrtle Beach-Conway SC",2007,3336,2386,8986,324,950,9310,10215,249711,-45,34820
"Myrtle Beach-North Myrtle Beach-Conway SC",2008,3318,2508,6627,327,810,6954,7669,257380,-95,34820
"Napa CA",2000,322,277,-9,218,45,209,259,124538,5,34900
"Napa CA",2001,1584,1327,1209,856,257,2065,2215,126753,-107,34900
"Napa CA",2002,1581,1281,871,810,300,1681,1886,128639,-95,34900
"Napa CA",2003,1650,1286,369,703,364,1072,1265,129904,-171,34900
"Napa CA",2004,1642,1276,-654,643,366,-11,245,130149,-110,34900
"Napa CA",2005,1597,1272,-982,684,325,-298,-93,130056,-120,34900
"Napa CA",2006,1733,1188,-353,681,545,328,810,130866,-63,34900
"Napa CA",2007,1717,1192,-218,615,525,397,915,131781,-7,34900
"Napa CA",2008,1718,1164,426,618,554,1044,1652,133433,54,34900
"Naples-Marco Island FL",2000,717,558,1906,645,159,2551,2658,254035,-52,34940
"Naples-Marco Island FL",2001,3282,2361,6764,2490,921,9254,10061,264096,-114,34940
"Naples-Marco Island FL",2002,3586,2410,7454,2344,1176,9798,10938,275034,-36,34940
"Naples-Marco Island FL",2003,3647,2406,5922,2077,1241,7999,9320,284354,80,34940
"Naples-Marco Island FL",2004,3795,2466,7537,1861,1329,9398,10278,294632,-449,34940
"Naples-Marco Island FL",2005,4015,2505,7627,1975,1510,9602,10849,305481,-263,34940
"Naples-Marco Island FL",2006,4221,2632,2736,1977,1589,4713,6121,311602,-181,34940
"Naples-Marco Island FL",2007,4129,2811,-1054,1805,1318,751,2053,313655,-16,34940
"Naples-Marco Island FL",2008,4073,2978,-1342,1805,1095,463,1603,315258,45,34940
"Nashville-Davidson--Murfreesboro--Franklin TN",2000,4683,2454,2526,1012,2229,3538,5725,1317514,-42,34980
"Nashville-Davidson--Murfreesboro--Franklin TN",2001,19654,10648,8171,3877,9006,12048,25888,1343402,4834,34980
"Nashville-Davidson--Murfreesboro--Franklin TN",2002,19463,10737,4164,3603,8726,7767,20429,1363831,3936,34980
"Nashville-Davidson--Murfreesboro--Franklin TN",2003,19547,11108,7332,3089,8439,10421,22713,1386544,3853,34980
"Nashville-Davidson--Murfreesboro--Franklin TN",2004,20423,11198,13458,2976,9225,16434,29380,1415924,3721,34980
"Nashville-Davidson--Murfreesboro--Franklin TN",2005,20817,11011,16605,3069,9806,19674,33479,1449403,3999,34980
"Nashville-Davidson--Murfreesboro--Franklin TN",2006,21892,11067,22834,3125,10825,25959,36286,1485689,-498,34980
"Nashville-Davidson--Murfreesboro--Franklin TN",2007,22509,11592,20638,2809,10917,23447,34471,1520160,107,34980
"Nashville-Davidson--Murfreesboro--Franklin TN",2008,22884,11862,16625,2840,11022,19465,30573,1550733,86,34980
"New Haven-Milford CT",2000,2561,1855,-620,828,706,208,977,824985,63,35300
"New Haven-Milford CT",2001,10259,7877,-1131,3019,2382,1888,3456,828441,-814,35300
"New Haven-Milford CT",2002,10107,7789,-409,2856,2318,2447,3930,832371,-835,35300
"New Haven-Milford CT",2003,10429,7479,818,2527,2950,3345,5081,837452,-1214,35300
"New Haven-Milford CT",2004,10185,7877,-2689,2347,2308,-342,1362,838814,-604,35300
"New Haven-Milford CT",2005,10179,7836,-2689,2458,2343,-231,1303,840117,-809,35300
"New Haven-Milford CT",2006,10196,7642,-3378,2972,2554,-406,1764,841881,-384,35300
"New Haven-Milford CT",2007,10573,7246,-3497,2617,3327,-880,2477,844358,30,35300
"New Haven-Milford CT",2008,10644,7223,-4497,2625,3421,-1872,1743,846101,194,35300
"New Orleans-Metairie-Kenner LA",2000,4457,2856,-3001,459,1601,-2542,-972,1315540,-31,35380
"New Orleans-Metairie-Kenner LA",2001,18969,12370,-12685,1588,6599,-11097,-4661,1310879,-163,35380
"New Orleans-Metairie-Kenner LA",2002,18755,12228,-7624,1279,6527,-6345,0,1310879,-182,35380
"New Orleans-Metairie-Kenner LA",2003,18668,12444,-6250,626,6224,-5624,421,1311300,-179,35380
"New Orleans-Metairie-Kenner LA",2004,18994,12469,-5223,1537,6525,-3686,2442,1313742,-397,35380
"New Orleans-Metairie-Kenner LA",2005,18587,12533,-8314,1239,6054,-7075,-1342,1312400,-321,35380
"New Orleans-Metairie-Kenner LA",2006,11888,11490,-321977,1470,398,-320507,-320498,991902,-389,35380
"New Orleans-Metairie-Kenner LA",2007,14275,9465,36155,1138,4810,37293,117509,1109411,75406,35380
"New Orleans-Metairie-Kenner LA",2008,14549,9969,20336,1225,4580,21561,24618,1134029,-1523,35380
"New York-Northern New Jersey-Long Island NY-NJ-PA",2000,64133,34093,-42207,42723,30040,516,29963,18353354,-593,35620
"New York-Northern New Jersey-Long Island NY-NJ-PA",2001,261113,145084,-176418,166837,116029,-9581,137703,18491057,31255,35620
"New York-Northern New Jersey-Long Island NY-NJ-PA",2002,258412,147874,-207800,157472,110538,-50328,102215,18593272,42005,35620
"New York-Northern New Jersey-Long Island NY-NJ-PA",2003,260839,143875,-236767,138747,116964,-98020,82991,18676263,64047,35620
"New York-Northern New Jersey-Long Island NY-NJ-PA",2004,261953,142855,-248028,125810,119098,-122218,81078,18757341,84198,35620
"New York-Northern New Jersey-Long Island NY-NJ-PA",2005,254199,140234,-284253,132549,113965,-151704,54696,18812037,92435,35620
"New York-Northern New Jersey-Long Island NY-NJ-PA",2006,250264,134787,-273991,135277,115477,-138714,36203,18848240,59440,35620
"New York-Northern New Jersey-Long Island NY-NJ-PA",2007,254171,136918,-219104,122908,117253,-96196,74331,18922571,53274,35620
"New York-Northern New Jersey-Long Island NY-NJ-PA",2008,255281,140134,-144099,123058,115147,-21041,84227,19006798,-9879,35620
"Niles-Benton Harbor MI",2000,515,356,-151,74,159,-77,83,162538,1,35660
"Niles-Benton Harbor MI",2001,2239,1625,-1777,368,614,-1409,-908,161630,-113,35660
"Niles-Benton Harbor MI",2002,2036,1578,-858,355,458,-503,-181,161449,-136,35660
"Niles-Benton Harbor MI",2003,2128,1551,-784,291,577,-493,-97,161352,-181,35660
"Niles-Benton Harbor MI",2004,2086,1671,-846,275,415,-571,-286,161066,-130,35660
"Niles-Benton Harbor MI",2005,2096,1631,-1637,286,465,-1351,-1032,160034,-146,35660
"Niles-Benton Harbor MI",2006,2159,1622,-1432,294,537,-1138,-668,159366,-67,35660
"Niles-Benton Harbor MI",2007,2025,1562,-778,260,463,-518,-20,159346,35,35660
"Niles-Benton Harbor MI",2008,2086,1560,-711,260,526,-451,135,159481,60,35660
"Norwich-New London CT",2000,758,528,-17,196,230,179,430,259536,21,35980
"Norwich-New London CT",2001,3062,2298,508,338,764,846,1365,260901,-245,35980
"Norwich-New London CT",2002,3157,2119,1236,-6,1038,1230,2044,262945,-224,35980
"Norwich-New London CT",2003,3197,2264,2243,-736,933,1507,2204,265149,-236,35980
"Norwich-New London CT",2004,3241,2259,-51,763,982,712,1523,266672,-171,35980
"Norwich-New London CT",2005,3112,2237,-2386,276,875,-2110,-1468,265204,-233,35980
"Norwich-New London CT",2006,3088,2177,1283,610,911,1893,2673,267877,-131,35980
"Norwich-New London CT",2007,3082,2074,-5467,250,1008,-5217,-4107,263770,102,35980
"Norwich-New London CT",2008,3200,2121,-765,393,1079,-372,749,264519,42,35980
"Ocala FL",2000,684,768,1377,93,-84,1470,1360,260274,-26,36100
"Ocala FL",2001,2886,3499,4525,362,-613,4887,4098,264372,-176,36100
"Ocala FL",2002,3010,3568,7067,343,-558,7410,6816,271188,-36,36100
"Ocala FL",2003,2874,3759,8201,289,-885,8490,7835,279023,230,36100
"Ocala FL",2004,3066,3803,11583,287,-737,11870,10589,289612,-544,36100
"Ocala FL",2005,3338,3813,12177,290,-475,12467,11824,301436,-168,36100
"Ocala FL",2006,3555,4019,12677,325,-464,13002,12325,313761,-213,36100
"Ocala FL",2007,3741,4208,10738,292,-467,11030,10332,324093,-231,36100
"Ocala FL",2008,3961,4392,6134,294,-431,6428,5535,329628,-462,36100
"Ocean City NJ",2000,269,236,-56,12,33,-44,-18,102308,-7,36140
"Ocean City NJ",2001,979,1273,-100,55,-294,-45,-447,101861,-108,36140
"Ocean City NJ",2002,1054,1376,-51,20,-322,-31,-446,101415,-93,36140
"Ocean City NJ",2003,1019,1243,304,-52,-224,252,-86,101329,-114,36140
"Ocean City NJ",2004,963,1355,-1029,97,-392,-932,-1414,99915,-90,36140
"Ocean City NJ",2005,898,1327,-899,42,-429,-857,-1358,98557,-72,36140
"Ocean City NJ",2006,922,1285,-711,102,-363,-609,-1019,97538,-47,36140
"Ocean City NJ",2007,953,1215,-943,62,-262,-881,-1210,96328,-67,36140
"Ocean City NJ",2008,993,1193,-266,74,-200,-192,-490,95838,-98,36140
"Odessa TX",2000,491,227,-767,53,264,-714,-458,120665,-8,36220
"Odessa TX",2001,2180,969,-1402,220,1211,-1182,-69,120596,-98,36220
"Odessa TX",2002,2229,1034,-80,211,1195,131,1206,121802,-120,36220
"Odessa TX",2003,2309,1074,-1026,193,1235,-833,294,122096,-108,36220
"Odessa TX",2004,2331,1086,-74,172,1245,98,1264,123360,-79,36220
"Odessa TX",2005,2292,1093,-275,180,1199,-95,990,124350,-114,36220
"Odessa TX",2006,2326,1096,754,178,1230,932,2099,126449,-63,36220
"Odessa TX",2007,2507,1074,1364,165,1433,1529,2961,129410,-1,36220
"Odessa TX",2008,2540,1076,901,166,1464,1067,2531,131941,0,36220
"Ogden-Clearfield UT",2000,2396,602,86,291,1794,377,2200,444856,29,36260
"Ogden-Clearfield UT",2001,8947,2507,-606,938,6440,332,7856,452712,1084,36260
"Ogden-Clearfield UT",2002,9122,2655,1071,648,6467,1719,9046,461758,860,36260
"Ogden-Clearfield UT",2003,9417,2545,1518,144,6872,1662,9409,471167,875,36260
"Ogden-Clearfield UT",2004,9756,2664,614,1041,7092,1655,9889,481056,1142,36260
"Ogden-Clearfield UT",2005,9669,2724,1667,712,6945,2379,10380,491436,1056,36260
"Ogden-Clearfield UT",2006,10055,2774,3133,916,7281,4049,11785,503221,455,36260
"Ogden-Clearfield UT",2007,10443,2641,5700,666,7802,6366,14284,517505,116,36260
"Ogden-Clearfield UT",2008,10967,2776,4933,730,8191,5663,13983,531488,129,36260
"Oklahoma City OK",2000,4027,2169,-439,922,1858,483,2412,1097834,71,36420
"Oklahoma City OK",2001,16221,9893,1220,3087,6328,4307,9689,1107523,-946,36420
"Oklahoma City OK",2002,16793,9724,3675,2578,7069,6253,12318,1119841,-1004,36420
"Oklahoma City OK",2003,17161,9746,3484,1514,7415,4998,11203,1131044,-1210,36420
"Oklahoma City OK",2004,17402,9982,-23,2848,7420,2825,9245,1140289,-1000,36420
"Oklahoma City OK",2005,17744,9913,4952,2440,7831,7392,14198,1154487,-1025,36420
"Oklahoma City OK",2006,18136,10088,8644,2714,8048,11358,18805,1173292,-601,36420
"Oklahoma City OK",2007,19016,9926,4664,2160,9090,6824,15866,1189158,-48,36420
"Oklahoma City OK",2008,19290,10072,5481,2305,9218,7786,16984,1206142,-20,36420
"Olympia WA",2000,660,376,538,116,284,654,930,208283,-8,36500
"Olympia WA",2001,2676,1575,2958,329,1101,3287,4226,212509,-162,36500
"Olympia WA",2002,2384,1635,3234,211,749,3445,4040,216549,-154,36500
"Olympia WA",2003,2558,1617,2696,-22,941,2674,3444,219993,-171,36500
"Olympia WA",2004,2645,1695,2285,389,950,2674,3424,223417,-200,36500
"Olympia WA",2005,2584,1714,3094,253,870,3347,4059,227476,-158,36500
"Olympia WA",2006,2682,1765,4276,328,917,4604,5386,232862,-135,36500
"Olympia WA",2007,2874,1795,4127,219,1079,4346,5304,238166,-121,36500
"Olympia WA",2008,2942,1784,5750,258,1158,6008,7015,245181,-151,36500
"Omaha-Council Bluffs NE-IA",2000,2976,1247,-404,567,1729,163,1930,769074,38,36540
"Omaha-Council Bluffs NE-IA",2001,12174,5965,-1176,1846,6209,670,6182,775256,-697,36540
"Omaha-Council Bluffs NE-IA",2002,12354,6079,-68,1384,6275,1316,6902,782158,-689,36540
"Omaha-Council Bluffs NE-IA",2003,12759,6025,1742,572,6734,2314,8094,790252,-954,36540
"Omaha-Council Bluffs NE-IA",2004,12890,5994,1767,1838,6896,3605,9903,800155,-598,36540
"Omaha-Council Bluffs NE-IA",2005,13020,5794,2164,1379,7226,3543,10000,810155,-769,36540
"Omaha-Council Bluffs NE-IA",2006,13251,5951,349,1671,7300,2020,8918,819073,-402,36540
"Omaha-Council Bluffs NE-IA",2007,13543,5988,-243,1261,7555,1018,8593,827666,20,36540
"Omaha-Council Bluffs NE-IA",2008,13801,6010,1071,1346,7791,2417,10259,837925,51,36540
"Orlando-Kissimmee FL",2000,5553,3104,7164,2641,2449,9805,12194,1656741,-60,36740
"Orlando-Kissimmee FL",2001,23967,13274,30423,9803,10693,40226,51388,1708129,469,36740
"Orlando-Kissimmee FL",2002,24099,13583,27098,9327,10516,36425,47343,1755472,402,36740
"Orlando-Kissimmee FL",2003,24729,13740,27184,8353,10989,35537,45889,1801361,-637,36740
"Orlando-Kissimmee FL",2004,25990,13675,44365,7798,12315,52163,62198,1863559,-2280,36740
"Orlando-Kissimmee FL",2005,27138,14019,51939,8143,13119,60082,71943,1935502,-1258,36740
"Orlando-Kissimmee FL",2006,28799,14136,34307,10480,14663,44787,58443,1993945,-1007,36740
"Orlando-Kissimmee FL",2007,29298,14859,11570,9176,14439,20746,34724,2028669,-461,36740
"Orlando-Kissimmee FL",2008,29530,15333,3153,9190,14197,12343,25905,2054574,-635,36740
"Oshkosh-Neenah WI",2000,477,261,54,36,216,90,313,157076,7,36780
"Oshkosh-Neenah WI",2001,1952,1243,-50,187,709,137,686,157762,-160,36780
"Oshkosh-Neenah WI",2002,1827,1258,19,179,569,198,610,158372,-157,36780
"Oshkosh-Neenah WI",2003,1801,1299,-598,153,502,-445,-150,158222,-207,36780
"Oshkosh-Neenah WI",2004,1762,1302,-195,151,460,-44,313,158535,-103,36780
"Oshkosh-Neenah WI",2005,1850,1294,350,155,556,505,913,159448,-148,36780
"Oshkosh-Neenah WI",2006,1861,1258,113,160,603,273,799,160247,-77,36780
"Oshkosh-Neenah WI",2007,1934,1274,258,144,660,402,1061,161308,-1,36780
"Oshkosh-Neenah WI",2008,1959,1245,-55,144,714,89,803,162111,0,36780
"Owensboro KY",2000,399,246,-35,7,153,-28,129,110004,4,36980
"Owensboro KY",2001,1598,1103,-596,48,495,-548,-151,109853,-98,36980
"Owensboro KY",2002,1579,1122,-309,43,457,-266,98,109951,-93,36980
"Owensboro KY",2003,1505,1045,-16,32,460,16,328,110279,-148,36980
"Owensboro KY",2004,1592,1093,-310,42,499,-268,150,110429,-81,36980
"Owensboro KY",2005,1565,1107,-71,40,458,-31,324,110753,-103,36980
"Owensboro KY",2006,1552,1071,64,41,481,105,535,111288,-51,36980
"Owensboro KY",2007,1590,1129,193,32,461,225,696,111984,10,36980
"Owensboro KY",2008,1606,1117,196,32,489,228,778,112762,61,36980
"Oxnard-Thousand Oaks-Ventura CA",2000,2879,1111,231,1173,1768,1404,3228,756414,56,37100
"Oxnard-Thousand Oaks-Ventura CA",2001,11609,4765,-971,4189,6844,3218,9296,765710,-766,37100
"Oxnard-Thousand Oaks-Ventura CA",2002,11452,4794,2092,3718,6658,5810,11711,777421,-757,37100
"Oxnard-Thousand Oaks-Ventura CA",2003,11891,4848,-882,2768,7043,1886,7799,785220,-1130,37100
"Oxnard-Thousand Oaks-Ventura CA",2004,11929,5179,-5126,3484,6750,-1642,4450,789670,-658,37100
"Oxnard-Thousand Oaks-Ventura CA",2005,12027,4598,-11190,3328,7429,-7862,-1105,788565,-672,37100
"Oxnard-Thousand Oaks-Ventura CA",2006,12405,4972,-7851,3449,7433,-4402,2682,791247,-349,37100
"Oxnard-Thousand Oaks-Ventura CA",2007,12236,4915,-9275,2949,7321,-6326,1209,792456,214,37100
"Oxnard-Thousand Oaks-Ventura CA",2008,12244,4951,-5233,3067,7293,-2166,5284,797740,157,37100
"Palm Bay-Melbourne-Titusville FL",2000,1168,1244,1330,225,-76,1555,1468,477698,-11,37340
"Palm Bay-Melbourne-Titusville FL",2001,4895,5179,8081,668,-284,8749,8145,485843,-320,37340
"Palm Bay-Melbourne-Titusville FL",2002,4836,5472,8771,510,-636,9281,8415,494258,-230,37340
"Palm Bay-Melbourne-Titusville FL",2003,4854,5421,9191,171,-567,9362,8737,502995,-58,37340
"Palm Bay-Melbourne-Titusville FL",2004,5093,5597,13502,675,-504,14177,12909,515904,-764,37340
"Palm Bay-Melbourne-Titusville FL",2005,5330,5683,10500,514,-353,11014,10176,526080,-485,37340
"Palm Bay-Melbourne-Titusville FL",2006,5445,5716,4761,661,-271,5422,4890,530970,-261,37340
"Palm Bay-Melbourne-Titusville FL",2007,5728,5806,3538,491,-78,4029,4035,535005,84,37340
"Palm Bay-Melbourne-Titusville FL",2008,5779,5932,1017,536,-153,1553,1516,536521,116,37340
"Palm Coast FL",2000,102,136,772,12,-34,784,721,50553,-29,37380
"Palm Coast FL",2001,408,639,3290,78,-231,3368,3142,53695,5,37380
"Palm Coast FL",2002,467,666,3791,75,-199,3866,3706,57401,39,37380
"Palm Coast FL",2003,544,713,4584,56,-169,4640,4702,62103,231,37380
"Palm Coast FL",2004,541,751,6468,58,-210,6526,6069,68172,-247,37380
"Palm Coast FL",2005,669,757,7228,59,-88,7287,7166,75338,-33,37380
"Palm Coast FL",2006,777,822,6981,66,-45,7047,6936,82274,-66,37380
"Palm Coast FL",2007,958,907,5799,58,51,5857,5904,88178,-4,37380
"Palm Coast FL",2008,952,916,3068,58,36,3126,3069,91247,-93,37380
"Panama City-Lynn Haven FL",2000,461,345,-166,74,116,-92,34,148252,10,37460
"Panama City-Lynn Haven FL",2001,2023,1390,946,87,633,1033,1531,149783,-135,37460
"Panama City-Lynn Haven FL",2002,1883,1485,2211,-136,398,2075,2375,152158,-98,37460
"Panama City-Lynn Haven FL",2003,2059,1472,2495,-566,587,1929,2484,154642,-32,37460
"Panama City-Lynn Haven FL",2004,2126,1475,2243,376,651,2619,3096,157738,-174,37460
"Panama City-Lynn Haven FL",2005,2376,1472,2912,48,904,2960,3720,161458,-144,37460
"Panama City-Lynn Haven FL",2006,2328,1488,1473,228,840,1701,2458,163916,-83,37460
"Panama City-Lynn Haven FL",2007,2443,1520,-1323,32,923,-1291,-362,163554,6,37460
"Panama City-Lynn Haven FL",2008,2328,1495,-516,108,833,-408,392,163946,-33,37460
"Parkersburg-Marietta-Vienna WV-OH",2000,445,408,-216,3,37,-213,-176,164444,0,37620
"Parkersburg-Marietta-Vienna WV-OH",2001,1901,1850,-543,26,51,-517,-612,163832,-146,37620
"Parkersburg-Marietta-Vienna WV-OH",2002,1874,1835,-434,21,39,-413,-519,163313,-145,37620
"Parkersburg-Marietta-Vienna WV-OH",2003,1796,1842,-456,11,-46,-445,-689,162624,-198,37620
"Parkersburg-Marietta-Vienna WV-OH",2004,1848,1827,-208,24,21,-184,-280,162344,-117,37620
"Parkersburg-Marietta-Vienna WV-OH",2005,1782,1760,-604,19,22,-585,-709,161635,-146,37620
"Parkersburg-Marietta-Vienna WV-OH",2006,1872,1755,-767,24,117,-743,-694,160941,-68,37620
"Parkersburg-Marietta-Vienna WV-OH",2007,1739,1766,-280,21,-27,-259,-262,160679,24,37620
"Parkersburg-Marietta-Vienna WV-OH",2008,1805,1816,-84,18,-11,-66,-1,160678,76,37620
"Pascagoula MS",2000,525,323,183,74,202,257,466,151030,7,37700
"Pascagoula MS",2001,2240,1374,117,129,866,246,961,151991,-151,37700
"Pascagoula MS",2002,2220,1339,-488,-13,881,-501,260,152251,-120,37700
"Pascagoula MS",2003,2166,1426,477,-310,740,167,692,152943,-215,37700
"Pascagoula MS",2004,2167,1387,512,305,780,817,1486,154429,-111,37700
"Pascagoula MS",2005,2169,1439,-37,97,730,60,652,155081,-138,37700
"Pascagoula MS",2006,2066,1448,-6388,224,618,-6164,-5595,149486,-49,37700
"Pascagoula MS",2007,2420,1318,1622,86,1102,1708,2651,152137,-159,37700
"Pascagoula MS",2008,2289,1306,132,130,983,262,963,153100,-282,37700
"Pensacola-Ferry Pass-Brent FL",2000,1244,879,354,276,365,630,1009,413162,14,37860
"Pensacola-Ferry Pass-Brent FL",2001,5385,3761,5587,254,1624,5841,7153,420315,-312,37860
"Pensacola-Ferry Pass-Brent FL",2002,5429,3825,6571,-523,1604,6048,7387,427702,-265,37860
"Pensacola-Ferry Pass-Brent FL",2003,5531,3836,6244,-2033,1695,4211,5711,433413,-195,37860
"Pensacola-Ferry Pass-Brent FL",2004,5721,3900,3807,1288,1821,5095,6419,439832,-497,37860
"Pensacola-Ferry Pass-Brent FL",2005,5696,3966,3303,132,1730,3435,4763,444595,-402,37860
"Pensacola-Ferry Pass-Brent FL",2006,6169,4003,3408,765,2166,4173,6108,450703,-231,37860
"Pensacola-Ferry Pass-Brent FL",2007,6355,3898,-1993,76,2457,-1917,688,451391,148,37860
"Pensacola-Ferry Pass-Brent FL",2008,6265,3971,-1099,346,2294,-753,1601,452992,60,37860
"Peoria IL",2000,1168,813,-706,69,355,-637,-284,366594,-2,37900
"Peoria IL",2001,4912,3616,-2807,328,1296,-2479,-1459,365135,-276,37900
"Peoria IL",2002,4791,3659,-818,293,1132,-525,299,365434,-308,37900
"Peoria IL",2003,4870,3711,-1683,195,1159,-1488,-691,364743,-362,37900
"Peoria IL",2004,4859,3708,95,284,1151,379,1287,366030,-243,37900
"Peoria IL",2005,4867,3823,327,263,1044,590,1324,367354,-310,37900
"Peoria IL",2006,4955,3560,-227,273,1395,46,1282,368636,-159,37900
"Peoria IL",2007,5067,3661,484,235,1406,719,2157,370793,32,37900
"Peoria IL",2008,5276,3651,-257,250,1625,-7,1694,372487,76,37900
"Philadelphia-Camden-Wilmington PA-NJ-DE-MD",2000,18366,12689,-3796,3943,5677,147,5766,5692916,-58,37980
"Philadelphia-Camden-Wilmington PA-NJ-DE-MD",2001,74448,54986,-14758,14370,19462,-388,14949,5707865,-4125,37980
"Philadelphia-Camden-Wilmington PA-NJ-DE-MD",2002,73990,54125,-7821,13103,19865,5282,21262,5729127,-3885,37980
"Philadelphia-Camden-Wilmington PA-NJ-DE-MD",2003,75583,54233,-7039,10738,21350,3699,19929,5749056,-5120,37980
"Philadelphia-Camden-Wilmington PA-NJ-DE-MD",2004,76629,53908,-8118,11384,22721,3266,22641,5771697,-3346,37980
"Philadelphia-Camden-Wilmington PA-NJ-DE-MD",2005,75469,53658,-13995,11305,21811,-2690,14939,5786636,-4182,37980
"Philadelphia-Camden-Wilmington PA-NJ-DE-MD",2006,76408,52360,-16119,12720,24048,-3399,18713,5805349,-1936,37980
"Philadelphia-Camden-Wilmington PA-NJ-DE-MD",2007,77247,52035,-18598,11065,25212,-7533,17936,5823285,257,37980
"Philadelphia-Camden-Wilmington PA-NJ-DE-MD",2008,77625,52522,-21848,11197,25103,-10651,15186,5838471,734,37980
"Phoenix-Mesa-Scottsdale AZ",2000,13347,5722,12854,6487,7625,19341,26889,3278776,-77,38060
"Phoenix-Mesa-Scottsdale AZ",2001,58028,24368,49818,25876,33660,75694,109014,3387790,-340,38060
"Phoenix-Mesa-Scottsdale AZ",2002,58404,25326,49846,24163,33078,74009,106764,3494554,-323,38060
"Phoenix-Mesa-Scottsdale AZ",2003,60907,25028,44673,20625,35879,65298,100934,3595488,-243,38060
"Phoenix-Mesa-Scottsdale AZ",2004,62415,25590,66231,19802,36825,86033,120484,3715972,-2374,38060
"Phoenix-Mesa-Scottsdale AZ",2005,64995,26044,98699,20484,38951,119183,157432,3873404,-702,38060
"Phoenix-Mesa-Scottsdale AZ",2006,68174,27731,102954,20602,40443,123556,161772,4035176,-2227,38060
"Phoenix-Mesa-Scottsdale AZ",2007,72225,25870,65949,18542,46355,84491,130745,4165921,-101,38060
"Phoenix-Mesa-Scottsdale AZ",2008,73738,27250,51077,18671,46488,69748,115978,4281899,-258,38060
"Pine Bluff AR",2000,350,266,-202,12,84,-190,-109,107237,-3,38220
"Pine Bluff AR",2001,1505,1113,-1121,74,392,-1047,-743,106494,-88,38220
"Pine Bluff AR",2002,1457,1092,-857,65,365,-792,-508,105986,-81,38220
"Pine Bluff AR",2003,1364,1116,-771,36,248,-735,-587,105399,-100,38220
"Pine Bluff AR",2004,1422,1122,-1155,58,300,-1097,-893,104506,-96,38220
"Pine Bluff AR",2005,1415,1125,-1133,51,290,-1082,-870,103636,-78,38220
"Pine Bluff AR",2006,1423,1034,-1308,57,389,-1251,-908,102728,-46,38220
"Pine Bluff AR",2007,1395,1055,-1497,45,340,-1452,-1120,101608,-8,38220
"Pine Bluff AR",2008,1397,1015,-1326,45,382,-1281,-961,100647,-62,38220
"Pittsburgh PA",2000,6623,6694,-2585,543,-71,-2042,-2074,2429014,39,38300
"Pittsburgh PA",2001,25855,28758,-8085,2424,-2903,-5661,-10763,2418251,-2199,38300
"Pittsburgh PA",2002,25037,28987,-5404,2204,-3950,-3200,-9304,2408947,-2154,38300
"Pittsburgh PA",2003,25300,28302,-4654,1807,-3002,-2847,-8732,2400215,-2883,38300
"Pittsburgh PA",2004,25159,28761,-8698,1862,-3602,-6836,-12333,2387882,-1895,38300
"Pittsburgh PA",2005,24197,28360,-11148,1875,-4163,-9273,-15526,2372356,-2090,38300
"Pittsburgh PA",2006,24513,27177,-9860,1969,-2664,-7891,-11606,2360750,-1051,38300
"Pittsburgh PA",2007,24255,27492,-5062,1711,-3237,-3351,-6591,2354159,-3,38300
"Pittsburgh PA",2008,24526,27303,-2432,1724,-2777,-708,-2967,2351192,518,38300
"Pittsfield MA",2000,302,352,-152,29,-50,-123,-166,134787,7,38340
"Pittsfield MA",2001,1202,1622,-671,143,-420,-528,-1069,133718,-121,38340
"Pittsfield MA",2002,1240,1570,-326,136,-330,-190,-635,133083,-115,38340
"Pittsfield MA",2003,1264,1583,-124,111,-319,-13,-518,132565,-186,38340
"Pittsfield MA",2004,1297,1546,-343,106,-249,-237,-580,131985,-94,38340
"Pittsfield MA",2005,1237,1558,-452,109,-321,-343,-792,131193,-128,38340
"Pittsfield MA",2006,1283,1468,-723,119,-185,-604,-843,130350,-54,38340
"Pittsfield MA",2007,1258,1467,-242,106,-209,-136,-318,130032,27,38340
"Pittsfield MA",2008,1307,1489,-634,106,-182,-528,-637,129395,73,38340
"Pocatello ID",2000,386,148,-187,20,238,-167,73,83176,2,38540
"Pocatello ID",2001,1513,603,-642,99,910,-543,1004,84180,637,38540
"Pocatello ID",2002,1495,628,-1002,94,867,-908,483,84663,524,38540
"Pocatello ID",2003,1528,683,-1411,75,845,-1336,57,84720,548,38540
"Pocatello ID",2004,1599,627,-559,84,972,-475,1035,85755,538,38540
"Pocatello ID",2005,1662,623,-731,82,1039,-649,389,86144,-1,38540
"Pocatello ID",2006,1547,634,-97,83,913,-14,899,87043,0,38540
"Pocatello ID",2007,1637,621,-560,75,1016,-485,528,87571,-3,38540
"Pocatello ID",2008,1661,629,-174,77,1032,-97,924,88495,-11,38540
"Port St. Lucie FL",2000,855,912,976,235,-57,1211,1137,320563,-17,38940
"Port St. Lucie FL",2001,3410,3913,5948,978,-503,6926,6257,326820,-166,38940
"Port St. Lucie FL",2002,3499,3942,8593,915,-443,9508,9013,335833,-52,38940
"Port St. Lucie FL",2003,3549,4062,10523,770,-513,11293,11074,346907,294,38940
"Port St. Lucie FL",2004,3849,4109,15315,747,-260,16062,15072,361979,-730,38940
"Port St. Lucie FL",2005,4232,4198,13235,765,34,14000,13682,375661,-352,38940
"Port St. Lucie FL",2006,4603,4106,10909,799,497,11708,11992,387653,-213,38940
"Port St. Lucie FL",2007,5024,4275,9511,731,749,10242,11227,398880,236,38940
"Port St. Lucie FL",2008,5118,4409,3243,733,709,3976,4888,403768,203,38940
"Portland-South Portland-Biddeford ME",2000,1444,1021,1194,151,423,1345,1762,489328,-6,38860
"Portland-South Portland-Biddeford ME",2001,5544,4261,4681,466,1283,5147,6030,495358,-400,38860
"Portland-South Portland-Biddeford ME",2002,5315,4398,4601,300,917,4901,5425,500783,-393,38860
"Portland-South Portland-Biddeford ME",2003,5638,4355,4321,-2,1283,4319,5136,505919,-466,38860
"Portland-South Portland-Biddeford ME",2004,5733,4345,1728,549,1388,2277,3284,509203,-381,38860
"Portland-South Portland-Biddeford ME",2005,5488,4453,970,357,1035,1327,1886,511089,-476,38860
"Portland-South Portland-Biddeford ME",2006,5547,4326,-1377,472,1221,-905,90,511179,-226,38860
"Portland-South Portland-Biddeford ME",2007,5633,4157,-681,322,1476,-359,1178,512357,61,38860
"Portland-South Portland-Biddeford ME",2008,5529,4207,-192,372,1322,180,1708,514065,206,38860
"Portland-Vancouver-Beaverton OR-WA",2000,7222,3358,1529,2788,3864,4317,8227,1936110,46,38900
"Portland-Vancouver-Beaverton OR-WA",2001,28469,14630,17123,10533,13839,27656,39834,1975944,-1661,38900
"Portland-Vancouver-Beaverton OR-WA",2002,27728,14816,14485,9853,12912,24338,35492,2011436,-1758,38900
"Portland-Vancouver-Beaverton OR-WA",2003,28509,14850,4025,8577,13659,12602,23953,2035389,-2308,38900
"Portland-Vancouver-Beaverton OR-WA",2004,28035,14912,485,7952,13123,8437,19524,2054913,-2036,38900
"Portland-Vancouver-Beaverton OR-WA",2005,28349,15128,12335,8312,13221,20647,32153,2087066,-1715,38900
"Portland-Vancouver-Beaverton OR-WA",2006,28833,14940,18366,8304,13893,26670,39409,2126475,-1154,38900
"Portland-Vancouver-Beaverton OR-WA",2007,30326,14552,17101,7550,15774,24651,40016,2166491,-409,38900
"Portland-Vancouver-Beaverton OR-WA",2008,30472,14884,17996,7574,15588,25570,40971,2207462,-187,38900
"Poughkeepsie-Newburgh-Middletown NY",2000,2075,1149,1156,462,926,1618,2571,624086,27,39100
"Poughkeepsie-Newburgh-Middletown NY",2001,8251,4727,4598,1520,3524,6118,9130,633216,-512,39100
"Poughkeepsie-Newburgh-Middletown NY",2002,8081,4811,4867,1202,3270,6069,8859,642075,-480,39100
"Poughkeepsie-Newburgh-Middletown NY",2003,8308,4753,6185,564,3555,6749,9803,651878,-501,39100
"Poughkeepsie-Newburgh-Middletown NY",2004,8534,4847,1970,1457,3687,3427,6638,658516,-476,39100
"Poughkeepsie-Newburgh-Middletown NY",2005,8355,4615,-666,1171,3740,505,3624,662140,-621,39100
"Poughkeepsie-Newburgh-Middletown NY",2006,8470,4557,-1616,1411,3913,-205,3396,665536,-312,39100
"Poughkeepsie-Newburgh-Middletown NY",2007,8527,4712,-1860,1096,3815,-764,3093,668629,42,39100
"Poughkeepsie-Newburgh-Middletown NY",2008,8794,4752,-1456,1190,4042,-266,3896,672525,120,39100
"Prescott AZ",2000,410,454,1350,90,-44,1440,1361,168878,-35,39140
"Prescott AZ",2001,1756,1866,4196,361,-110,4557,4387,173265,-60,39140
"Prescott AZ",2002,1809,2053,5031,338,-244,5369,5081,178346,-44,39140
"Prescott AZ",2003,1919,2048,4725,275,-129,5000,4967,183313,96,39140
"Prescott AZ",2004,1934,2149,6354,272,-215,6626,6098,189411,-313,39140
"Prescott AZ",2005,2026,2222,8002,277,-196,8279,7956,197367,-127,39140
"Prescott AZ",2006,2221,2396,8964,281,-175,9245,8933,206300,-137,39140
"Prescott AZ",2007,2502,2286,5446,257,216,5703,5879,212179,-40,39140
"Prescott AZ",2008,2513,2380,3018,260,133,3278,3324,215503,-87,39140
"Providence-New Bedford-Fall River RI-MA",2000,4884,3457,1031,1255,1427,2286,3797,1586794,84,39300
"Providence-New Bedford-Fall River RI-MA",2001,19114,15153,3047,4375,3961,7422,9911,1596705,-1472,39300
"Providence-New Bedford-Fall River RI-MA",2002,19036,14945,5679,3916,4091,9595,12295,1609000,-1391,39300
"Providence-New Bedford-Fall River RI-MA",2003,19328,15069,3428,3126,4259,6554,8695,1617695,-2118,39300
"Providence-New Bedford-Fall River RI-MA",2004,19939,15212,-7485,3593,4727,-3892,-396,1617299,-1231,39300
"Providence-New Bedford-Fall River RI-MA",2005,18991,14876,-13530,3483,4115,-10047,-7361,1609938,-1429,39300
"Providence-New Bedford-Fall River RI-MA",2006,18983,14437,-14282,4118,4546,-10164,-6306,1603632,-688,39300
"Providence-New Bedford-Fall River RI-MA",2007,18985,14196,-13766,3514,4789,-10252,-5284,1598348,179,39300
"Providence-New Bedford-Fall River RI-MA",2008,19237,14180,-10626,3564,5057,-7062,-1737,1596611,268,39300
"Provo-Orem UT",2000,2586,373,489,400,2213,889,3128,379906,26,39340
"Provo-Orem UT",2001,10335,1667,2974,1509,8668,4483,16306,396212,3155,39340
"Provo-Orem UT",2002,10493,1656,-78,1417,8837,1339,9545,405757,-631,39340
"Provo-Orem UT",2003,10940,1849,-548,1217,9091,669,12418,418175,2658,39340
"Provo-Orem UT",2004,11121,1824,361,1130,9297,1491,24721,442896,13933,39340
"Provo-Orem UT",2005,11211,1762,2372,1178,9449,3550,20837,463733,7838,39340
"Provo-Orem UT",2006,11705,1808,5489,1180,9897,6669,27426,491159,10860,39340
"Provo-Orem UT",2007,12447,1853,8440,1071,10594,9511,31672,522831,11567,39340
"Provo-Orem UT",2008,13071,1910,5727,1073,11161,6800,17989,540820,28,39340
"Pueblo CO",2000,455,340,192,47,115,239,361,141833,7,39380
"Pueblo CO",2001,2007,1393,1599,182,614,1781,2286,144119,-109,39380
"Pueblo CO",2002,1996,1483,2003,169,513,2172,2607,146726,-78,39380
"Pueblo CO",2003,2058,1453,638,132,605,770,1204,147930,-171,39380
"Pueblo CO",2004,1948,1534,202,149,414,351,667,148597,-98,39380
"Pueblo CO",2005,1997,1553,659,142,444,801,1106,149703,-139,39380
"Pueblo CO",2006,2024,1424,1319,151,600,1470,1995,151698,-75,39380
"Pueblo CO",2007,2174,1435,2044,136,739,2180,2980,154678,61,39380
"Pueblo CO",2008,2221,1515,1130,140,706,1270,2059,156737,83,39380
"Punta Gorda FL",2000,234,519,878,44,-285,922,612,142239,-25,39460
"Punta Gorda FL",2001,1047,2146,4653,187,-1099,4840,3680,145919,-61,39460
"Punta Gorda FL",2002,999,2176,4416,182,-1177,4598,3427,149346,6,39460
"Punta Gorda FL",2003,1058,2208,3509,150,-1150,3659,2623,151969,114,39460
"Punta Gorda FL",2004,1025,2308,5532,139,-1283,5671,4088,156057,-300,39460
"Punta Gorda FL",2005,1105,2295,-1925,147,-1190,-1778,-2915,153142,53,39460
"Punta Gorda FL",2006,1128,2037,543,152,-909,695,-338,152804,-124,39460
"Punta Gorda FL",2007,1195,2156,1142,138,-961,1280,-325,152479,-644,39460
"Punta Gorda FL",2008,1200,2096,-655,138,-896,-517,-2419,150060,-1006,39460
"Racine WI",2000,649,350,-239,75,299,-164,141,188974,6,39540
"Racine WI",2001,2624,1656,-830,286,968,-544,964,189938,540,39540
"Racine WI",2002,2579,1506,-318,267,1073,-51,1424,191362,402,39540
"Racine WI",2003,2536,1529,39,225,1007,264,1605,192967,334,39540
"Racine WI",2004,2533,1500,-41,216,1033,175,1734,194701,526,39540
"Racine WI",2005,2594,1548,368,226,1046,594,2097,196798,457,39540
"Racine WI",2006,2596,1536,-490,239,1060,-251,1285,198083,476,39540
"Racine WI",2007,2694,1521,-921,209,1173,-712,935,199018,474,39540
"Racine WI",2008,2666,1460,-939,209,1206,-730,492,199510,16,39540
"Raleigh-Cary NC",2000,3107,1101,3900,1397,2006,5297,7298,804363,-5,39580
"Raleigh-Cary NC",2001,13286,4769,16177,5217,8517,21394,31091,835454,1180,39580
"Raleigh-Cary NC",2002,13622,4639,12950,4866,8983,17816,27771,863225,972,39580
"Raleigh-Cary NC",2003,13843,4818,11559,4205,9025,15764,25853,889078,1064,39580
"Raleigh-Cary NC",2004,14556,5227,14569,3938,9329,18507,27547,916625,-289,39580
"Raleigh-Cary NC",2005,14890,5167,22686,4104,9723,26790,36468,953093,-45,39580
"Raleigh-Cary NC",2006,15756,5137,29350,4138,10619,33488,44022,997115,-85,39580
"Raleigh-Cary NC",2007,16480,5291,31473,3741,11189,35214,46846,1043961,443,39580
"Raleigh-Cary NC",2008,17175,5570,29268,3766,11605,33034,44804,1088765,165,39580
"Rapid City SD",2000,431,214,-77,48,217,-29,189,113007,1,39660
"Rapid City SD",2001,1770,822,288,48,948,336,1171,114178,-113,39660
"Rapid City SD",2002,1751,834,366,-100,917,266,1067,115245,-116,39660
"Rapid City SD",2003,1824,946,279,-373,878,-94,629,115874,-155,39660
"Rapid City SD",2004,1914,866,468,240,1048,708,1669,117543,-87,39660
"Rapid City SD",2005,1909,920,-421,23,989,-398,488,118031,-103,39660
"Rapid City SD",2006,1917,890,-196,140,1027,-56,914,118945,-57,39660
"Rapid City SD",2007,2025,815,84,10,1210,94,1342,120287,38,39660
"Rapid City SD",2008,1984,863,996,57,1121,1053,2235,122522,61,39660
"Reading PA",2000,1193,854,323,169,339,492,859,374497,28,39740
"Reading PA",2001,4704,3712,1280,633,992,1913,2571,377068,-334,39740
"Reading PA",2002,4668,3571,1989,599,1097,2588,3379,380447,-306,39740
"Reading PA",2003,4738,3655,2579,531,1083,3110,3838,384285,-355,39740
"Reading PA",2004,5018,3575,2929,525,1443,3454,4550,388835,-347,39740
"Reading PA",2005,4999,3606,2931,531,1393,3462,4470,393305,-385,39740
"Reading PA",2006,5060,3468,2890,761,1592,3651,5048,398353,-195,39740
"Reading PA",2007,5244,3640,767,656,1604,1423,3126,401479,99,39740
"Reading PA",2008,5322,3612,-462,657,1710,195,2116,403595,211,39740
"Redding CA",2000,473,399,427,29,74,456,526,163782,-4,39820
"Redding CA",2001,1850,1751,3063,129,99,3192,3180,166962,-111,39820
"Redding CA",2002,1995,1841,3969,122,154,4091,4167,171129,-78,39820
"Redding CA",2003,1959,1839,3099,96,120,3195,3277,174406,-38,39820
"Redding CA",2004,2091,1844,1874,102,247,1976,2060,176466,-163,39820
"Redding CA",2005,2092,1924,981,101,168,1082,1075,177541,-175,39820
"Redding CA",2006,2135,1947,502,103,188,605,711,178252,-82,39820
"Redding CA",2007,2264,1920,351,91,344,442,816,179068,30,39820
"Redding CA",2008,2328,1820,497,94,508,591,1146,180214,47,39820
"Reno-Sparks NV",2000,1251,612,756,491,639,1247,1893,344778,7,39900
"Reno-Sparks NV",2001,5072,2594,6125,1872,2478,7997,10228,355006,-247,39900
"Reno-Sparks NV",2002,5172,2758,5936,1748,2414,7684,9871,364877,-227,39900
"Reno-Sparks NV",2003,5413,2841,5409,1525,2572,6934,9289,374166,-217,39900
"Reno-Sparks NV",2004,5457,2881,6502,1428,2576,7930,10076,384242,-430,39900
"Reno-Sparks NV",2005,5535,2991,5799,1488,2544,7287,9504,393746,-327,39900
"Reno-Sparks NV",2006,5953,2969,3128,1494,2984,4622,7390,401136,-216,39900
"Reno-Sparks NV",2007,6056,3127,3494,1361,2929,4855,7751,408887,-33,39900
"Reno-Sparks NV",2008,6047,3201,1629,1365,2846,2994,5897,414784,57,39900
"Richmond VA",2000,3649,2243,1240,574,1406,1814,3179,1100126,-41,40060
"Richmond VA",2001,14918,9718,4538,2048,5200,6586,10753,1110879,-1033,40060
"Richmond VA",2002,14726,9567,8124,1629,5159,9753,14088,1124967,-824,40060
"Richmond VA",2003,14831,9722,8622,805,5109,9427,13777,1138744,-759,40060
"Richmond VA",2004,15291,9897,9189,1975,5394,11164,15369,1154113,-1189,40060
"Richmond VA",2005,15569,9894,12689,1581,5675,14270,18978,1173091,-967,40060
"Richmond VA",2006,15945,9684,13292,1857,6261,15149,20784,1193875,-626,40060
"Richmond VA",2007,16269,9809,9497,1466,6460,10963,17226,1211101,-197,40060
"Richmond VA",2008,16791,10169,6562,1545,6622,8107,14525,1225626,-204,40060
"Riverside-San Bernardino-Ontario CA",2000,12816,5373,11688,4059,7443,15747,23135,3277952,-55,40140
"Riverside-San Bernardino-Ontario CA",2001,54032,23961,57212,14982,30071,72194,100121,3378073,-2144,40140
"Riverside-San Bernardino-Ontario CA",2002,55074,24581,66484,13310,30493,79794,108758,3486831,-1529,40140
"Riverside-San Bernardino-Ontario CA",2003,58290,24816,85910,9762,33474,95672,130299,3617130,1153,40140
"Riverside-San Bernardino-Ontario CA",2004,59701,25984,95221,12487,33717,107708,135951,3753081,-5474,40140
"Riverside-San Bernardino-Ontario CA",2005,62988,25383,72502,11908,37605,84410,118510,3871591,-3505,40140
"Riverside-San Bernardino-Ontario CA",2006,66345,26778,61177,12380,39567,73557,110921,3982512,-2203,40140
"Riverside-San Bernardino-Ontario CA",2007,70117,26657,29715,10561,43460,40276,84061,4066573,325,40140
"Riverside-San Bernardino-Ontario CA",2008,72512,26982,-7608,10992,45530,3384,49298,4115871,384,40140
"Roanoke VA",2000,844,728,18,66,116,84,193,288442,-7,40220
"Roanoke VA",2001,3317,3202,-26,331,115,305,149,288591,-271,40220
"Roanoke VA",2002,3381,3209,-160,313,172,153,105,288696,-220,40220
"Roanoke VA",2003,3205,3136,557,257,69,814,630,289326,-253,40220
"Roanoke VA",2004,3380,3123,566,280,257,846,846,290172,-257,40220
"Roanoke VA",2005,3357,3166,1421,274,191,1695,1638,291810,-248,40220
"Roanoke VA",2006,3463,3307,2077,286,156,2363,2371,294181,-148,40220
"Roanoke VA",2007,3555,3219,1644,257,336,1901,2174,296355,-63,40220
"Roanoke VA",2008,3584,3189,1209,256,395,1465,1753,298108,-107,40220
"Rochester MN",2000,621,239,211,171,382,382,773,164390,9,40340
"Rochester MN",2001,2385,1068,370,720,1317,1090,2235,166625,-172,40340
"Rochester MN",2002,2519,1101,838,672,1418,1510,2780,169405,-148,40340
"Rochester MN",2003,2569,1138,518,579,1431,1097,2305,171710,-223,40340
"Rochester MN",2004,2667,1118,359,536,1549,895,2317,174027,-127,40340
"Rochester MN",2005,2728,1111,-106,558,1617,452,1902,175929,-167,40340
"Rochester MN",2006,2792,1130,306,556,1662,862,2432,178361,-92,40340
"Rochester MN",2007,2732,1163,-143,501,1569,358,1944,180305,17,40340
"Rochester MN",2008,2831,1168,391,498,1663,889,2619,182924,67,40340
"Rochester NY",2000,3343,2127,2194,525,1216,2719,3969,1041805,34,40380
"Rochester NY",2001,12637,8988,-5165,1985,3649,-3180,-422,1041383,-891,40380
"Rochester NY",2002,12246,8864,-4396,1874,3382,-2522,8,1041391,-852,40380
"Rochester NY",2003,12357,8898,-5056,1632,3459,-3424,-1132,1040259,-1167,40380
"Rochester NY",2004,12157,9049,-5104,1536,3108,-3568,-1286,1038973,-826,40380
"Rochester NY",2005,11701,9035,-7550,1603,2666,-5947,-4201,1034772,-920,40380
"Rochester NY",2006,11972,8498,-6773,1831,3474,-4942,-1915,1032857,-447,40380
"Rochester NY",2007,12125,8891,-5508,1615,3234,-3893,-369,1032488,290,40380
"Rochester NY",2008,12103,8808,-3750,1628,3295,-2122,1602,1034090,429,40380
"Rockford IL",2000,1155,618,-24,267,537,243,797,321003,17,40420
"Rockford IL",2001,4499,2778,-275,998,1721,723,2930,323933,486,40420
"Rockford IL",2002,4620,2813,-12,934,1807,922,3108,327041,379,40420
"Rockford IL",2003,4646,2831,1319,830,1815,2149,4212,331253,248,40420
"Rockford IL",2004,4612,2815,517,760,1797,1277,3520,334773,446,40420
"Rockford IL",2005,4655,2938,1488,815,1717,2303,4421,339194,401,40420
"Rockford IL",2006,4753,2829,2736,809,1924,3545,5440,344634,-29,40420
"Rockford IL",2007,4946,2838,3703,728,2108,4431,6626,351260,87,40420
"Rockford IL",2008,5197,2903,-41,732,2294,691,3134,354394,149,40420
"Rocky Mount NC",2000,504,342,-145,48,162,-97,52,143043,-13,40580
"Rocky Mount NC",2001,2090,1506,-336,216,584,-120,258,143301,-206,40580
"Rocky Mount NC",2002,2039,1526,-524,201,513,-323,6,143307,-184,40580
"Rocky Mount NC",2003,1892,1473,-246,155,419,-91,103,143410,-225,40580
"Rocky Mount NC",2004,1934,1491,-205,171,443,-34,263,143673,-146,40580
"Rocky Mount NC",2005,1999,1568,-410,170,431,-240,131,143804,-60,40580
"Rocky Mount NC",2006,1874,1476,50,174,398,224,571,144375,-51,40580
"Rocky Mount NC",2007,2057,1499,296,152,558,448,958,145333,-48,40580
"Rocky Mount NC",2008,2096,1515,365,157,581,522,1023,146356,-80,40580
"Rome GA",2000,314,235,83,63,79,146,231,90796,6,40660
"Rome GA",2001,1390,979,-227,251,411,24,340,91136,-95,40660
"Rome GA",2002,1326,973,946,241,353,1187,1443,92579,-97,40660
"Rome GA",2003,1450,1032,334,217,418,551,863,93442,-106,40660
"Rome GA",2004,1403,998,-121,203,405,82,423,93865,-64,40660
"Rome GA",2005,1326,960,-160,212,366,52,328,94193,-90,40660
"Rome GA",2006,1461,985,173,211,476,384,813,95006,-47,40660
"Rome GA",2007,1479,1002,-295,196,477,-99,358,95364,-20,40660
"Rome GA",2008,1432,1009,-41,198,423,157,616,95980,36,40660
"Sacramento--Arden-Arcade--Roseville CA",2000,6148,3065,6089,2548,3083,8637,11648,1808500,-72,40900
"Sacramento--Arden-Arcade--Roseville CA",2001,25665,13602,37274,9736,12063,47010,57908,1866408,-1165,40900
"Sacramento--Arden-Arcade--Roseville CA",2002,26639,14093,35844,9062,12546,44906,56552,1922960,-900,40900
"Sacramento--Arden-Arcade--Roseville CA",2003,27545,14079,25874,7736,13466,33610,45942,1968902,-1134,40900
"Sacramento--Arden-Arcade--Roseville CA",2004,28457,14444,18293,7501,14013,25794,37967,2006869,-1840,40900
"Sacramento--Arden-Arcade--Roseville CA",2005,29219,14465,4757,7735,14754,12492,25517,2032386,-1729,40900
"Sacramento--Arden-Arcade--Roseville CA",2006,30037,14936,1779,7769,15101,9548,23603,2055989,-1046,40900
"Sacramento--Arden-Arcade--Roseville CA",2007,30784,15081,3757,6967,15703,10724,26197,2082186,-230,40900
"Sacramento--Arden-Arcade--Roseville CA",2008,31392,15146,4524,7038,16246,11562,27646,2109832,-162,40900
"Saginaw-Saginaw Township North MI",2000,707,476,-388,30,231,-358,-116,209926,11,40980
"Saginaw-Saginaw Township North MI",2001,2753,2091,-1211,157,662,-1054,-575,209351,-183,40980
"Saginaw-Saginaw Township North MI",2002,2802,2079,-1010,152,723,-858,-309,209042,-174,40980
"Saginaw-Saginaw Township North MI",2003,2639,2025,-1389,125,614,-1264,-866,208176,-216,40980
"Saginaw-Saginaw Township North MI",2004,2655,2009,-997,123,646,-874,-392,207784,-164,40980
"Saginaw-Saginaw Township North MI",2005,2629,2133,-1761,126,496,-1635,-1327,206457,-188,40980
"Saginaw-Saginaw Township North MI",2006,2632,2097,-2177,129,535,-2048,-1595,204862,-82,40980
"Saginaw-Saginaw Township North MI",2007,2552,2099,-3282,111,453,-3171,-2590,202272,128,40980
"Saginaw-Saginaw Township North MI",2008,2569,1992,-2288,111,577,-2177,-1527,200745,73,40980
"Salem OR",2000,1342,764,-95,499,578,404,999,348216,17,41420
"Salem OR",2001,5222,2926,433,1966,2296,2399,4352,352568,-343,41420
"Salem OR",2002,5284,3089,2043,1844,2195,3887,5781,358349,-301,41420
"Salem OR",2003,5282,3042,843,1618,2240,2461,4216,362565,-485,41420
"Salem OR",2004,5480,3149,610,1480,2331,2090,4115,366680,-306,41420
"Salem OR",2005,5485,2966,1319,1571,2519,2890,5099,371779,-310,41420
"Salem OR",2006,5688,2919,2692,1565,2769,4257,6820,378599,-206,41420
"Salem OR",2007,5933,2917,2160,1405,3016,3565,6509,385108,-72,41420
"Salem OR",2008,6102,3031,2123,1406,3071,3529,6572,391680,-28,41420
"Salinas CA",2000,1703,585,-948,1151,1118,203,1334,403095,13,41500
"Salinas CA",2001,7003,2475,-4114,4167,4528,53,4255,407350,-326,41500
"Salinas CA",2002,7257,2349,-5872,3682,4908,-2190,2460,409810,-258,41500
"Salinas CA",2003,7304,2415,-5704,2663,4889,-3041,1575,411385,-273,41500
"Salinas CA",2004,7394,2452,-9122,3552,4942,-5570,-1162,410223,-534,41500
"Salinas CA",2005,7499,2300,-11604,3342,5199,-8262,-3336,406887,-273,41500
"Salinas CA",2006,7429,2384,-11324,3475,5045,-7849,-2965,403922,-161,41500
"Salinas CA",2007,7426,2360,-7305,2965,5066,-4340,724,404646,-2,41500
"Salinas CA",2008,7451,2320,-4485,3098,5131,-1387,3592,408238,-152,41500
"Salisbury MD",2000,370,262,37,39,108,76,191,109582,7,41540
"Salisbury MD",2001,1417,1072,419,185,345,604,849,110431,-100,41540
"Salisbury MD",2002,1373,1057,492,174,316,666,878,111309,-104,41540
"Salisbury MD",2003,1408,1076,987,132,332,1119,1350,112659,-101,41540
"Salisbury MD",2004,1445,1144,1148,152,301,1300,1495,114154,-106,41540
"Salisbury MD",2005,1482,1081,1247,147,401,1394,1706,115860,-89,41540
"Salisbury MD",2006,1512,1082,1488,158,430,1646,2011,117871,-65,41540
"Salisbury MD",2007,1636,1174,952,133,462,1085,1494,119365,-53,41540
"Salisbury MD",2008,1646,1152,219,134,494,353,800,120165,-47,41540
"Salt Lake City UT",2000,5133,1277,-1663,1504,3856,-159,3723,972606,26,41620
"Salt Lake City UT",2001,19777,5451,-7345,6110,14326,-1235,16294,988900,3203,41620
"Salt Lake City UT",2002,19550,5586,-9342,5706,13964,-3636,12978,1001878,2650,41620
"Salt Lake City UT",2003,20129,5538,-10140,4936,14591,-5204,14858,1016736,5471,41620
"Salt Lake City UT",2004,20182,5713,-6322,4618,14469,-1704,14570,1031306,1805,41620
"Salt Lake City UT",2005,19885,5595,-2146,4797,14290,2651,14599,1045905,-2342,41620
"Salt Lake City UT",2006,20517,5593,2296,4816,14924,7112,28349,1074254,6313,41620
"Salt Lake City UT",2007,21084,5523,1301,4355,15561,5656,21108,1095362,-109,41620
"Salt Lake City UT",2008,21283,5741,243,4369,15542,4612,20330,1115692,176,41620
"San Angelo TX",2000,403,221,-218,67,182,-151,29,105810,-2,41660
"San Angelo TX",2001,1613,1044,-842,91,569,-751,-270,105540,-88,41660
"San Angelo TX",2002,1527,1027,-133,-50,500,-183,220,105760,-97,41660
"San Angelo TX",2003,1659,974,418,-360,685,58,612,106372,-131,41660
"San Angelo TX",2004,1584,1027,-632,281,557,-351,120,106492,-86,41660
"San Angelo TX",2005,1609,1004,-416,67,605,-349,153,106645,-103,41660
"San Angelo TX",2006,1605,973,115,175,632,290,870,107515,-52,41660
"San Angelo TX",2007,1719,972,41,40,747,81,836,108351,8,41660
"San Angelo TX",2008,1732,983,337,98,749,435,1212,109563,28,41660
"San Antonio TX",2000,6875,2989,1902,1663,3886,3565,7553,1719270,102,41700
"San Antonio TX",2001,28484,12730,5651,4803,15754,10454,24600,1743870,-1608,41700
"San Antonio TX",2002,28465,12901,16252,3176,15564,19428,33705,1777575,-1287,41700
"San Antonio TX",2003,29393,13083,16578,-354,16310,16224,31086,1808661,-1448,41700
"San Antonio TX",2004,30078,13232,15025,5727,16846,20752,35943,1844604,-1655,41700
"San Antonio TX",2005,30304,13397,15605,3761,16907,19366,34525,1879129,-1748,41700
"San Antonio TX",2006,31015,13382,31421,4857,17633,36278,52865,1931994,-1046,41700
"San Antonio TX",2007,32316,13885,30910,3211,18431,34121,52927,1984921,375,41700
"San Antonio TX",2008,33813,14144,22791,3796,19669,26587,46524,2031445,268,41700
"San Diego-Carlsbad-San Marcos CA",2000,10635,4596,-490,5744,6039,5254,11561,2825395,268,41740
"San Diego-Carlsbad-San Marcos CA",2001,44094,19886,6446,16254,24208,22700,44235,2869630,-2673,41740
"San Diego-Carlsbad-San Marcos CA",2002,43809,19634,3674,10909,24175,14583,35979,2905609,-2779,41740
"San Diego-Carlsbad-San Marcos CA",2003,44948,19442,1133,-591,25506,542,21702,2927311,-4346,41740
"San Diego-Carlsbad-San Marcos CA",2004,45221,20463,-38101,19083,24758,-19018,2742,2930053,-2998,41740
"San Diego-Carlsbad-San Marcos CA",2005,46090,19120,-36060,13251,26970,-22809,1636,2931689,-2525,41740
"San Diego-Carlsbad-San Marcos CA",2006,46298,19903,-35785,16007,26395,-19778,5334,2937023,-1283,41740
"San Diego-Carlsbad-San Marcos CA",2007,47001,19553,-15553,10750,27448,-4803,22711,2959734,66,41740
"San Diego-Carlsbad-San Marcos CA",2008,47565,19962,420,12987,27603,13407,41338,3001072,328,41740
"San Francisco-Oakland-Fremont CA",2000,14106,6986,-3531,9792,7120,6261,13524,4137271,143,41860
"San Francisco-Oakland-Fremont CA",2001,57443,30174,-24917,38223,27269,13306,44008,4181279,3433,41860
"San Francisco-Oakland-Fremont CA",2002,56482,29736,-79116,35981,26746,-43135,-12718,4168561,3671,41860
"San Francisco-Oakland-Fremont CA",2003,56724,29365,-74174,31542,27359,-42632,-10959,4157602,4314,41860
"San Francisco-Oakland-Fremont CA",2004,55869,28955,-64659,28792,26914,-35867,-7982,4149620,971,41860
"San Francisco-Oakland-Fremont CA",2005,55305,28401,-51236,30288,26904,-20948,7983,4157603,2027,41860
"San Francisco-Oakland-Fremont CA",2006,55505,28827,-40504,30138,26678,-10366,20008,4177611,3696,41860
"San Francisco-Oakland-Fremont CA",2007,55251,29082,-20536,27434,26169,6898,38514,4216125,5447,41860
"San Francisco-Oakland-Fremont CA",2008,54818,29660,5506,27504,25158,33010,58406,4274531,238,41860
"San Jose-Sunnyvale-Santa Clara CA",2000,6985,2170,-6862,6282,4815,-580,4159,1739977,-76,41940
"San Jose-Sunnyvale-Santa Clara CA",2001,28637,9216,-36884,24902,19421,-11982,6376,1746353,-1063,41940
"San Jose-Sunnyvale-Santa Clara CA",2002,27847,8862,-58476,23519,18985,-34957,-15944,1730409,28,41940
"San Jose-Sunnyvale-Santa Clara CA",2003,28103,9028,-44179,20648,19075,-23531,-4028,1726381,428,41940
"San Jose-Sunnyvale-Santa Clara CA",2004,27694,8799,-33479,18688,18895,-14791,1999,1728380,-2105,41940
"San Jose-Sunnyvale-Santa Clara CA",2005,27291,8866,-22154,19728,18425,-2426,14503,1742883,-1496,41940
"San Jose-Sunnyvale-Santa Clara CA",2006,27618,9196,-17797,19610,18422,1813,19375,1762258,-860,41940
"San Jose-Sunnyvale-Santa Clara CA",2007,27671,9373,-11903,17882,18298,5979,24097,1786355,-180,41940
"San Jose-Sunnyvale-Santa Clara CA",2008,27477,9468,-2625,17905,18009,15280,32843,1819198,-446,41940
"San Luis Obispo-Paso Robles CA",2000,630,443,840,168,187,1008,1195,247876,0,42020
"San Luis Obispo-Paso Robles CA",2001,2450,2082,2846,604,368,3450,3649,251525,-169,42020
"San Luis Obispo-Paso Robles CA",2002,2331,2010,796,563,321,1359,1460,252985,-220,42020
"San Luis Obispo-Paso Robles CA",2003,2572,2054,695,473,518,1168,1368,254353,-318,42020
"San Luis Obispo-Paso Robles CA",2004,2677,2102,1050,475,575,1525,1897,256250,-203,42020
"San Luis Obispo-Paso Robles CA",2005,2648,1914,552,492,734,1044,1529,257779,-249,42020
"San Luis Obispo-Paso Robles CA",2006,2686,2175,993,492,511,1485,1871,259650,-125,42020
"San Luis Obispo-Paso Robles CA",2007,2868,2125,867,431,743,1298,2116,261766,75,42020
"San Luis Obispo-Paso Robles CA",2008,3039,2098,2002,439,941,2441,3531,265297,149,42020
"Sandusky OH",2000,251,190,-13,6,61,-7,54,79605,0,41780
"Sandusky OH",2001,924,790,-473,26,134,-447,-377,79228,-64,41780
"Sandusky OH",2002,922,862,-614,25,60,-589,-585,78643,-56,41780
"Sandusky OH",2003,932,799,-231,20,133,-211,-171,78472,-93,41780
"Sandusky OH",2004,945,824,-190,21,121,-169,-107,78365,-59,41780
"Sandusky OH",2005,869,873,-528,22,-4,-506,-579,77786,-69,41780
"Sandusky OH",2006,804,773,-384,23,31,-361,-363,77423,-33,41780
"Sandusky OH",2007,886,863,-322,17,23,-305,-261,77162,21,41780
"Sandusky OH",2008,911,838,-247,17,73,-230,-100,77062,57,41780
"Santa Barbara-Santa Maria-Goleta CA",2000,1417,681,-1029,760,736,-269,470,399826,3,42060
"Santa Barbara-Santa Maria-Goleta CA",2001,5713,2888,-3431,2776,2825,-655,1864,401690,-306,42060
"Santa Barbara-Santa Maria-Goleta CA",2002,5638,2975,-4028,2489,2663,-1539,839,402529,-285,42060
"Santa Barbara-Santa Maria-Goleta CA",2003,5724,2865,-3823,1902,2859,-1921,554,403083,-384,42060
"Santa Barbara-Santa Maria-Goleta CA",2004,5962,2916,-5851,2276,3046,-3575,-955,402128,-426,42060
"Santa Barbara-Santa Maria-Goleta CA",2005,6315,2957,-5793,2211,3358,-3582,-552,401576,-328,42060
"Santa Barbara-Santa Maria-Goleta CA",2006,6195,2889,-6589,2274,3306,-4315,-1183,400393,-174,42060
"Santa Barbara-Santa Maria-Goleta CA",2007,6142,2818,-3549,1970,3324,-1579,1699,402092,-46,42060
"Santa Barbara-Santa Maria-Goleta CA",2008,6312,2892,-2115,2037,3420,-78,3304,405396,-38,42060
"Santa Cruz-Watsonville CA",2000,861,389,-606,387,472,-219,250,255850,-3,42100
"Santa Cruz-Watsonville CA",2001,3509,1696,-3200,1498,1813,-1702,-96,255754,-207,42100
"Santa Cruz-Watsonville CA",2002,3459,1677,-4910,1410,1782,-3500,-1837,253917,-119,42100
"Santa Cruz-Watsonville CA",2003,3291,1691,-4812,1250,1600,-3562,-2018,251899,-56,42100
"Santa Cruz-Watsonville CA",2004,3489,1678,-3655,1124,1811,-2531,-994,250905,-274,42100
"Santa Cruz-Watsonville CA",2005,3418,1571,-4122,1182,1847,-2940,-1302,249603,-209,42100
"Santa Cruz-Watsonville CA",2006,3460,1567,-2922,1176,1893,-1746,40,249643,-107,42100
"Santa Cruz-Watsonville CA",2007,3517,1602,-2029,1082,1915,-947,1012,250655,44,42100
"Santa Cruz-Watsonville CA",2008,3461,1636,-481,1084,1825,603,2482,253137,54,42100
"Santa Fe NM",2000,400,172,105,184,228,289,527,129822,10,42140
"Santa Fe NM",2001,1611,785,299,740,826,1039,1741,131563,-124,42140
"Santa Fe NM",2002,1529,802,1492,698,727,2190,2827,134390,-90,42140
"Santa Fe NM",2003,1667,840,615,611,827,1226,1885,136275,-168,42140
"Santa Fe NM",2004,1634,868,250,568,766,818,1492,137767,-92,42140
"Santa Fe NM",2005,1614,845,183,592,769,775,1423,139190,-121,42140
"Santa Fe NM",2006,1690,892,137,595,798,732,1458,140648,-72,42140
"Santa Fe NM",2007,1656,956,511,537,700,1048,1721,142369,-27,42140
"Santa Fe NM",2008,1677,969,273,540,708,813,1568,143937,47,42140
"Santa Rosa-Petaluma CA",2000,1446,857,528,668,589,1196,1809,460425,24,42220
"Santa Rosa-Petaluma CA",2001,5648,3932,490,2447,1716,2937,4183,464608,-470,42220
"Santa Rosa-Petaluma CA",2002,5708,3926,-4435,2276,1782,-2159,-706,463902,-329,42220
"Santa Rosa-Petaluma CA",2003,5806,3809,-3128,1921,1997,-1207,320,464222,-470,42220
"Santa Rosa-Petaluma CA",2004,5910,3874,-3805,1875,2036,-1930,-307,463915,-413,42220
"Santa Rosa-Petaluma CA",2005,5746,3645,-5249,1938,2101,-3311,-1616,462299,-406,42220
"Santa Rosa-Petaluma CA",2006,5774,3773,-5097,1942,2001,-3155,-1352,460947,-198,42220
"Santa Rosa-Petaluma CA",2007,5879,3730,-2669,1743,2149,-926,1343,462290,120,42220
"Santa Rosa-Petaluma CA",2008,5948,3766,291,1763,2182,2054,4451,466741,215,42220
"Savannah GA",2000,1021,607,-240,191,414,-49,358,293660,-7,42340
"Savannah GA",2001,4518,2753,1383,445,1765,1828,3333,296993,-260,42340
"Savannah GA",2002,4459,2649,2840,190,1810,3030,4632,301625,-208,42340
"Savannah GA",2003,4596,2668,2039,-352,1928,1687,3309,304934,-306,42340
"Savannah GA",2004,4715,2796,3052,684,1919,3736,5356,310290,-299,42340
"Savannah GA",2005,4863,2689,1663,341,2174,2004,3888,314178,-290,42340
"Savannah GA",2006,4931,2698,4402,539,2233,4941,7007,321185,-167,42340
"Savannah GA",2007,5223,2734,5242,291,2489,5533,8122,329307,100,42340
"Savannah GA",2008,5340,2756,2018,382,2584,2400,5046,334353,62,42340
"Scranton--Wilkes-Barre PA",2000,1337,1787,-724,50,-450,-674,-1117,559514,7,42540
"Scranton--Wilkes-Barre PA",2001,5562,7602,-1649,295,-2040,-1354,-3919,555595,-525,42540
"Scranton--Wilkes-Barre PA",2002,5379,7617,-760,279,-2238,-481,-3247,552348,-528,42540
"Scranton--Wilkes-Barre PA",2003,5457,7514,542,209,-2057,751,-2029,550319,-723,42540
"Scranton--Wilkes-Barre PA",2004,5571,7693,761,250,-2122,1011,-1504,548815,-393,42540
"Scranton--Wilkes-Barre PA",2005,5712,7302,1343,236,-1590,1579,-559,548256,-548,42540
"Scranton--Wilkes-Barre PA",2006,5704,7184,1236,266,-1480,1502,-225,548031,-247,42540
"Scranton--Wilkes-Barre PA",2007,5903,7059,1793,218,-1156,2011,1021,549052,166,42540
"Scranton--Wilkes-Barre PA",2008,5955,7023,608,220,-1068,828,98,549150,338,42540
"Seattle-Tacoma-Bellevue WA",2000,10587,4907,-1672,4495,5680,2823,8598,3052495,95,42660
"Seattle-Tacoma-Bellevue WA",2001,41004,20888,4962,16244,20116,21206,41664,3094159,342,42660
"Seattle-Tacoma-Bellevue WA",2002,40406,20998,-7177,14142,19408,6965,26652,3120811,279,42660
"Seattle-Tacoma-Bellevue WA",2003,40491,21080,-12931,10029,19411,-2902,16154,3136965,-355,42660
"Seattle-Tacoma-Bellevue WA",2004,41770,21082,-10269,13762,20688,3493,23572,3160537,-609,42660
"Seattle-Tacoma-Bellevue WA",2005,41640,21222,5125,12705,20418,17830,36833,3197370,-1415,42660
"Seattle-Tacoma-Bellevue WA",2006,43358,20798,21252,13513,22560,34765,56607,3253977,-718,42660
"Seattle-Tacoma-Bellevue WA",2007,43887,21695,10281,11409,22192,21690,44248,3298225,366,42660
"Seattle-Tacoma-Bellevue WA",2008,43417,21886,11869,11866,21531,23735,46588,3344813,1322,42660
"Sebastian-Vero Beach FL",2000,257,351,460,72,-94,532,433,113376,-5,42680
"Sebastian-Vero Beach FL",2001,1097,1570,2124,311,-473,2435,1911,115287,-51,42680
"Sebastian-Vero Beach FL",2002,1117,1614,2691,290,-497,2981,2459,117746,-25,42680
"Sebastian-Vero Beach FL",2003,1152,1597,2199,232,-445,2431,1994,119740,8,42680
"Sebastian-Vero Beach FL",2004,1212,1843,4846,231,-631,5077,4219,123959,-227,42680
"Sebastian-Vero Beach FL",2005,1281,1859,3084,234,-578,3318,2619,126578,-121,42680
"Sebastian-Vero Beach FL",2006,1409,1633,2781,236,-224,3017,2722,129300,-71,42680
"Sebastian-Vero Beach FL",2007,1435,1690,2155,217,-255,2372,2146,131446,29,42680
"Sebastian-Vero Beach FL",2008,1531,1685,779,218,-154,997,869,132315,26,42680
"Sheboygan WI",2000,236,242,42,45,-6,87,89,112745,8,43100
"Sheboygan WI",2001,1106,1068,33,170,38,203,127,112872,-114,43100
"Sheboygan WI",2002,1389,1053,-317,164,336,-153,82,112954,-101,43100
"Sheboygan WI",2003,1366,1035,-332,146,331,-186,0,112954,-145,43100
"Sheboygan WI",2004,1365,1050,-101,133,315,32,272,113226,-75,43100
"Sheboygan WI",2005,1442,1041,6,142,401,148,437,113663,-112,43100
"Sheboygan WI",2006,1448,1097,-206,143,351,-63,235,113898,-53,43100
"Sheboygan WI",2007,1442,1032,-235,125,410,-110,308,114206,8,43100
"Sheboygan WI",2008,1466,984,-300,124,482,-176,355,114561,49,43100
"Sherman-Denison TX",2000,393,301,237,66,92,303,391,110986,-4,43300
"Sherman-Denison TX",2001,1490,1298,1051,242,192,1293,1395,112381,-90,43300
"Sherman-Denison TX",2002,1636,1263,397,226,373,623,892,113273,-104,43300
"Sherman-Denison TX",2003,1560,1206,694,185,354,879,1111,114384,-122,43300
"Sherman-Denison TX",2004,1619,1224,50,179,395,229,548,114932,-76,43300
"Sherman-Denison TX",2005,1583,1233,212,188,350,400,645,115577,-105,43300
"Sherman-Denison TX",2006,1600,1241,763,190,359,953,1252,116829,-60,43300
"Sherman-Denison TX",2007,1613,1266,697,165,347,862,1237,118066,28,43300
"Sherman-Denison TX",2008,1729,1206,11,168,523,179,738,118804,36,43300
"Shreveport-Bossier City LA",2000,1341,826,-476,96,515,-380,151,376122,16,43340
"Shreveport-Bossier City LA",2001,5699,3795,-1943,160,1904,-1783,-207,375915,-328,43340
"Shreveport-Bossier City LA",2002,5630,3710,-1320,-110,1920,-1430,199,376114,-291,43340
"Shreveport-Bossier City LA",2003,5440,3696,56,-666,1744,-610,676,376790,-458,43340
"Shreveport-Bossier City LA",2004,5664,3827,566,497,1837,1063,2631,379421,-269,43340
"Shreveport-Bossier City LA",2005,5694,3797,344,83,1897,427,1970,381391,-354,43340
"Shreveport-Bossier City LA",2006,5750,3835,3487,315,1915,3802,5522,386913,-195,43340
"Shreveport-Bossier City LA",2007,5933,3818,-1642,73,2115,-1569,587,387500,41,43340
"Shreveport-Bossier City LA",2008,5966,3760,-359,164,2206,-195,2033,389533,22,43340
"Sioux City IA-NE-SD",2000,543,289,-446,141,254,-305,-58,142995,-7,43580
"Sioux City IA-NE-SD",2001,2298,1214,-2109,595,1084,-1514,-525,142470,-95,43580
"Sioux City IA-NE-SD",2002,2280,1319,-1622,564,961,-1058,-190,142280,-93,43580
"Sioux City IA-NE-SD",2003,2235,1300,-1626,468,935,-1158,-312,141968,-89,43580
"Sioux City IA-NE-SD",2004,2343,1202,-1511,463,1141,-1048,-49,141919,-142,43580
"Sioux City IA-NE-SD",2005,2218,1236,-2441,465,982,-1976,-1102,140817,-108,43580
"Sioux City IA-NE-SD",2006,2276,1192,-653,474,1084,-179,839,141656,-66,43580
"Sioux City IA-NE-SD",2007,2297,1266,-766,425,1031,-341,684,142340,-6,43580
"Sioux City IA-NE-SD",2008,2203,1197,-602,426,1006,-176,817,143157,-13,43580
"Sioux Falls SD",2000,707,302,689,117,405,806,1211,188306,0,43620
"Sioux Falls SD",2001,2910,1437,1954,453,1473,2407,4908,193214,1028,43620
"Sioux Falls SD",2002,2965,1439,1521,417,1526,1938,4310,197524,846,43620
"Sioux Falls SD",2003,3045,1454,2301,346,1591,2647,5166,202690,928,43620
"Sioux Falls SD",2004,3336,1477,2828,374,1859,3202,5990,208680,929,43620
"Sioux Falls SD",2005,3365,1494,2735,368,1871,3103,5991,214671,1017,43620
"Sioux Falls SD",2006,3484,1581,3446,384,1903,3830,6791,221462,1058,43620
"Sioux Falls SD",2007,3665,1476,3029,337,2189,3366,5531,226993,-24,43620
"Sioux Falls SD",2008,3802,1565,3415,348,2237,3763,5937,232930,-63,43620
"South Bend-Mishawaka IN-MI",2000,1144,664,-373,172,480,-201,292,316953,13,43780
"South Bend-Mishawaka IN-MI",2001,4425,2886,-2294,668,1539,-1626,-365,316588,-278,43780
"South Bend-Mishawaka IN-MI",2002,4292,2930,-2258,628,1362,-1630,-509,316079,-241,43780
"South Bend-Mishawaka IN-MI",2003,4225,2775,-2292,546,1450,-1746,-620,315459,-324,43780
"South Bend-Mishawaka IN-MI",2004,4412,2929,-1711,503,1483,-1208,12,315471,-263,43780
"South Bend-Mishawaka IN-MI",2005,4295,3051,-1508,531,1244,-977,-7,315464,-274,43780
"South Bend-Mishawaka IN-MI",2006,4411,2917,-1532,534,1494,-998,348,315812,-148,43780
"South Bend-Mishawaka IN-MI",2007,4469,2836,-1644,481,1633,-1163,421,316233,-49,43780
"South Bend-Mishawaka IN-MI",2008,4398,2789,-1411,481,1609,-930,632,316865,-47,43780
"Spartanburg SC",2000,770,596,307,119,174,426,614,254396,14,43900
"Spartanburg SC",2001,3413,2623,1246,495,790,1741,2297,256693,-234,43900
"Spartanburg SC",2002,3385,2510,1130,469,875,1599,2256,258949,-218,43900
"Spartanburg SC",2003,3465,2575,841,391,890,1232,1794,260743,-328,43900
"Spartanburg SC",2004,3423,2618,826,363,805,1189,1807,262550,-187,43900
"Spartanburg SC",2005,3441,2683,1797,386,758,2183,2732,265282,-209,43900
"Spartanburg SC",2006,3581,2559,2995,390,1022,3385,4264,269546,-143,43900
"Spartanburg SC",2007,3833,2653,4233,346,1180,4579,5739,275285,-20,43900
"Spartanburg SC",2008,3703,2704,4119,349,999,4468,5453,280738,-14,43900
"Spokane WA",2000,1466,871,-51,289,595,238,867,418806,34,44060
"Spokane WA",2001,5550,3730,1732,831,1820,2563,3974,422780,-409,44060
"Spokane WA",2002,5469,3662,2260,616,1807,2876,4303,427083,-380,44060
"Spokane WA",2003,5506,3617,2295,232,1889,2527,3908,430991,-508,44060
"Spokane WA",2004,5496,3722,1945,831,1774,2776,4234,435225,-316,44060
"Spokane WA",2005,5490,3726,3169,635,1764,3804,5206,440431,-362,44060
"Spokane WA",2006,5738,3645,3884,760,2093,4644,6501,446932,-236,44060
"Spokane WA",2007,6143,3733,6155,561,2410,6716,9072,456004,-54,44060
"Spokane WA",2008,6219,3758,3629,621,2461,4250,6673,462677,-38,44060
"Springfield IL",2000,686,444,-142,30,242,-112,140,201584,10,44100
"Springfield IL",2001,2837,1985,-291,98,852,-193,1182,202766,523,44100
"Springfield IL",2002,2555,1922,61,79,633,140,1165,203931,392,44100
"Springfield IL",2003,2693,1912,-311,15,781,-296,355,204286,-130,44100
"Springfield IL",2004,2720,1980,-429,119,740,-310,461,204747,31,44100
"Springfield IL",2005,2706,1991,-556,93,715,-463,229,204976,-23,44100
"Springfield IL",2006,2565,1978,-3,103,587,100,678,205654,-9,44100
"Springfield IL",2007,2723,1915,-280,73,808,-207,638,206292,37,44100
"Springfield IL",2008,2791,1956,75,85,835,160,1097,207389,102,44100
"Springfield MA",2000,1912,1523,-487,496,389,9,421,680437,23,44140
"Springfield MA",2001,7784,6559,-2528,1772,1225,-756,-142,680295,-611,44140
"Springfield MA",2002,7694,6397,903,1676,1297,2579,3233,683528,-643,44140
"Springfield MA",2003,7782,6332,185,1454,1450,1639,2088,685616,-1001,44140
"Springfield MA",2004,7679,6527,-1948,1483,1152,-465,198,685814,-489,44140
"Springfield MA",2005,7528,6229,-2052,1501,1299,-551,117,685931,-631,44140
"Springfield MA",2006,7685,6395,-2355,2163,1290,-192,784,686715,-314,44140
"Springfield MA",2007,7825,6212,-3363,1866,1613,-1497,226,686941,110,44140
"Springfield MA",2008,7975,6175,-3271,1874,1800,-1397,617,687558,214,44140
"Springfield MO",2000,1256,807,898,52,449,950,1396,369771,-3,44180
"Springfield MO",2001,4995,3474,3529,227,1521,3756,4952,374723,-325,44180
"Springfield MO",2002,4852,3562,3719,206,1290,3925,4918,379641,-297,44180
"Springfield MO",2003,5020,3626,4569,135,1394,4704,5857,385498,-241,44180
"Springfield MO",2004,5240,3651,5861,193,1589,6054,7217,392715,-426,44180
"Springfield MO",2005,5606,3582,5826,177,2024,6003,7695,400410,-332,44180
"Springfield MO",2006,5626,3689,7806,193,1937,7999,9713,410123,-223,44180
"Springfield MO",2007,5982,3458,6741,160,2524,6901,9484,419607,59,44180
"Springfield MO",2008,6271,3622,3671,170,2649,3841,6537,426144,47,44180
"Springfield OH",2000,449,396,-144,6,53,-138,-78,144660,7,44220
"Springfield OH",2001,1997,1662,-985,31,335,-954,-734,143926,-115,44220
"Springfield OH",2002,1823,1605,-641,19,218,-622,-524,143402,-120,44220
"Springfield OH",2003,1743,1688,-1454,-2,55,-1456,-1493,141909,-92,44220
"Springfield OH",2004,1807,1633,-447,42,174,-405,-341,141568,-110,44220
"Springfield OH",2005,1747,1675,14,24,72,38,-14,141554,-124,44220
"Springfield OH",2006,1764,1581,-743,35,183,-708,-588,140966,-63,44220
"Springfield OH",2007,1904,1565,-1078,26,339,-1052,-673,140293,40,44220
"Springfield OH",2008,1880,1594,-808,28,286,-780,-434,139859,60,44220
"St. Cloud MN",2000,612,269,238,39,343,277,631,168022,11,41060
"St. Cloud MN",2001,2299,1110,810,186,1189,996,3623,171645,1438,41060
"St. Cloud MN",2002,2319,1092,845,178,1227,1023,3424,175069,1174,41060
"St. Cloud MN",2003,2368,1080,270,137,1288,407,2837,177906,1142,41060
"St. Cloud MN",2004,2403,1087,-66,142,1316,76,1437,179343,45,41060
"St. Cloud MN",2005,2464,1089,481,144,1375,625,1991,181334,-9,41060
"St. Cloud MN",2006,2604,1111,282,148,1493,430,1923,183257,0,41060
"St. Cloud MN",2007,2576,1130,710,123,1446,833,2286,185543,7,41060
"St. Cloud MN",2008,2673,1149,-280,123,1524,-157,1411,186954,44,41060
"St. George UT",2000,493,176,568,42,317,610,900,91254,-27,41100
"St. George UT",2001,1741,665,2180,171,1076,2351,3359,94613,-68,41100
"St. George UT",2002,1949,715,3426,166,1234,3592,4799,99412,-27,41100
"St. George UT",2003,2042,718,3314,144,1324,3458,4833,104245,51,41100
"St. George UT",2004,2242,828,4661,135,1414,4796,6008,110253,-202,41100
"St. George UT",2005,2287,791,7222,141,1496,7363,8823,119076,-36,41100
"St. George UT",2006,2677,924,6206,142,1753,6348,7997,127073,-104,41100
"St. George UT",2007,2813,815,4444,127,1998,4571,6374,133447,-195,41100
"St. George UT",2008,2954,921,2326,127,2033,2453,4142,137589,-344,41100
"St. Joseph MO-KS",2000,383,300,53,8,83,61,149,123969,5,41140
"St. Joseph MO-KS",2001,1460,1325,-503,37,135,-466,-5,123964,326,41140
"St. Joseph MO-KS",2002,1519,1293,-505,28,226,-477,-9,123955,242,41140
"St. Joseph MO-KS",2003,1493,1291,-405,-1,202,-406,13,123968,217,41140
"St. Joseph MO-KS",2004,1474,1279,-1021,46,195,-975,-508,123460,272,41140
"St. Joseph MO-KS",2005,1506,1324,-361,31,182,-330,112,123572,260,41140
"St. Joseph MO-KS",2006,1552,1319,147,41,233,188,705,124277,284,41140
"St. Joseph MO-KS",2007,1812,1263,620,26,549,646,1554,125831,359,41140
"St. Joseph MO-KS",2008,1724,1214,-42,34,510,-8,528,126359,26,41140
"St. Louis MO-IL",2000,9054,5754,-1585,1175,3300,-410,2873,2701537,-17,41180
"St. Louis MO-IL",2001,36167,25359,-4420,4129,10808,-291,17321,2718858,6804,41180
"St. Louis MO-IL",2002,36008,25889,-4495,3541,10119,-954,14324,2733182,5159,41180
"St. Louis MO-IL",2003,35653,25965,-2145,2145,9688,0,10498,2743680,810,41180
"St. Louis MO-IL",2004,36649,25770,-4724,3748,10879,-976,15383,2759063,5480,41180
"St. Louis MO-IL",2005,36328,24931,-7880,3365,11397,-4515,14093,2773156,7211,41180
"St. Louis MO-IL",2006,36635,24798,-3670,3611,11837,-59,17604,2790760,5826,41180
"St. Louis MO-IL",2007,38067,24269,-6901,2916,13798,-3985,14705,2805465,4892,41180
"St. Louis MO-IL",2008,38185,24510,-5567,3092,13675,-2475,11245,2816710,45,41180
"State College PA",2000,299,192,-127,162,107,35,151,135911,9,44300
"State College PA",2001,1272,860,-23,671,412,648,925,136836,-135,44300
"State College PA",2002,1225,892,1562,626,333,2188,2430,139266,-91,44300
"State College PA",2003,1307,919,491,542,388,1033,1237,140503,-184,44300
"State College PA",2004,1347,878,-391,523,469,132,500,141003,-101,44300
"State College PA",2005,1218,868,-315,530,350,215,436,141439,-129,44300
"State College PA",2006,1313,880,1426,543,433,1969,2330,143769,-72,44300
"State College PA",2007,1385,907,-1009,497,478,-512,-1,143768,33,44300
"State College PA",2008,1381,936,6,498,445,504,1011,144779,62,44300
"Stockton CA",2000,2294,1019,2308,848,1275,3156,4420,568023,-11,44700
"Stockton CA",2001,9841,4431,14817,3261,5410,18078,23240,591263,-248,44700
"Stockton CA",2002,10141,4532,9237,3070,5609,12307,17595,608858,-321,44700
"Stockton CA",2003,10204,4687,9171,2689,5517,11860,17156,626014,-221,44700
"Stockton CA",2004,10648,4436,8038,2453,6212,10491,16035,642049,-668,44700
"Stockton CA",2005,11230,4645,5251,2582,6585,7833,13817,655866,-601,44700
"Stockton CA",2006,11753,4861,-2598,2565,6892,-33,6529,662395,-330,44700
"Stockton CA",2007,11737,4619,-4062,2349,7118,-1713,5491,667886,86,44700
"Stockton CA",2008,11805,4731,-5175,2356,7074,-2819,4502,672388,247,44700
"Sumter SC",2000,402,246,-211,68,156,-143,18,104654,5,44940
"Sumter SC",2001,1775,913,-1246,14,862,-1232,-442,104212,-72,44940
"Sumter SC",2002,1601,903,198,-160,698,38,639,104851,-97,44940
"Sumter SC",2003,1609,947,42,-590,662,-548,-34,104817,-148,44940
"Sumter SC",2004,1658,958,-621,329,700,-292,325,105142,-83,44940
"Sumter SC",2005,1647,949,-1045,46,698,-999,-393,104749,-92,44940
"Sumter SC",2006,1696,948,-1542,189,748,-1353,-648,104101,-43,44940
"Sumter SC",2007,1659,1038,-750,-4,621,-754,-93,104008,40,44940
"Sumter SC",2008,1625,1000,-587,74,625,-513,140,104148,28,44940
"Syracuse NY",2000,2102,1374,-1445,317,728,-1128,-372,649782,28,45060
"Syracuse NY",2001,8088,5666,-3828,1100,2422,-2728,-880,648902,-574,45060
"Syracuse NY",2002,7817,5696,-2657,1015,2121,-1642,-97,648805,-576,45060
"Syracuse NY",2003,7726,5709,-1123,848,2017,-275,914,649719,-828,45060
"Syracuse NY",2004,7752,5675,-2916,852,2077,-2064,-476,649243,-489,45060
"Syracuse NY",2005,7650,5687,-5081,877,1963,-4204,-2791,646452,-550,45060
"Syracuse NY",2006,7398,5525,-4141,980,1873,-3161,-1580,644872,-292,45060
"Syracuse NY",2007,7731,5618,-3839,850,2113,-2989,-898,643974,-22,45060
"Syracuse NY",2008,7906,5556,-3360,863,2350,-2497,-180,643794,-33,45060
"Tallahassee FL",2000,979,583,460,154,396,614,1025,321334,15,45220
"Tallahassee FL",2001,4148,2278,966,628,1870,1594,3187,324521,-277,45220
"Tallahassee FL",2002,3997,2394,1108,575,1603,1683,2999,327520,-287,45220
"Tallahassee FL",2003,4202,2395,3189,475,1807,3664,5213,332733,-258,45220
"Tallahassee FL",2004,4262,2278,2026,486,1984,2512,4228,336961,-268,45220
"Tallahassee FL",2005,4266,2328,2444,493,1938,2937,4587,341548,-288,45220
"Tallahassee FL",2006,4391,2373,3433,510,2018,3943,5780,347328,-181,45220
"Tallahassee FL",2007,4626,2428,3433,461,2198,3894,6097,353425,5,45220
"Tallahassee FL",2008,4716,2510,1110,462,2206,1572,3834,357259,56,45220
"Tampa-St. Petersburg-Clearwater FL",2000,6891,6592,5694,2421,299,8115,8270,2404281,-144,45300
"Tampa-St. Petersburg-Clearwater FL",2001,29404,29186,30512,8927,218,39439,37978,2442259,-1679,45300
"Tampa-St. Petersburg-Clearwater FL",2002,29175,29168,34285,8082,7,42367,41049,2483308,-1325,45300
"Tampa-St. Petersburg-Clearwater FL",2003,29496,28438,32262,6555,1058,38817,38885,2522193,-990,45300
"Tampa-St. Petersburg-Clearwater FL",2004,30545,28977,49427,7186,1568,56613,54857,2577050,-3324,45300
"Tampa-St. Petersburg-Clearwater FL",2005,31603,28396,52008,7093,3207,59101,59986,2637036,-2322,45300
"Tampa-St. Petersburg-Clearwater FL",2006,32782,28645,39331,8024,4137,47355,50055,2687091,-1437,45300
"Tampa-St. Petersburg-Clearwater FL",2007,33835,28825,16117,6935,5010,23052,28182,2715273,120,45300
"Tampa-St. Petersburg-Clearwater FL",2008,33755,29198,6510,7050,4557,13560,18488,2733761,371,45300
"Terre Haute IN",2000,531,455,-249,29,76,-220,-141,170813,3,45460
"Terre Haute IN",2001,2081,1998,-676,133,83,-543,-616,170197,-156,45460
"Terre Haute IN",2002,2154,2046,-870,117,108,-753,-779,169418,-134,45460
"Terre Haute IN",2003,2090,1989,80,83,101,163,39,169457,-225,45460
"Terre Haute IN",2004,2116,2001,-785,113,115,-672,-701,168756,-144,45460
"Terre Haute IN",2005,2034,1791,165,100,243,265,356,169112,-152,45460
"Terre Haute IN",2006,2148,1835,476,112,313,588,820,169932,-81,45460
"Terre Haute IN",2007,2086,1868,-111,98,218,-13,179,170111,-26,45460
"Terre Haute IN",2008,2165,1863,-279,96,302,-183,122,170233,3,45460
"Texarkana TX-Texarkana AR",2000,423,301,-214,19,122,-195,-65,129684,8,45500
"Texarkana TX-Texarkana AR",2001,1766,1404,-135,81,362,-54,184,129868,-124,45500
"Texarkana TX-Texarkana AR",2002,1713,1344,-1,74,369,73,319,130187,-123,45500
"Texarkana TX-Texarkana AR",2003,1717,1378,364,46,339,410,573,130760,-176,45500
"Texarkana TX-Texarkana AR",2004,1617,1403,582,67,214,649,768,131528,-95,45500
"Texarkana TX-Texarkana AR",2005,1709,1379,449,62,330,511,722,132250,-119,45500
"Texarkana TX-Texarkana AR",2006,1831,1312,1074,66,519,1140,1592,133842,-67,45500
"Texarkana TX-Texarkana AR",2007,1862,1248,-290,53,614,-237,382,134224,5,45500
"Texarkana TX-Texarkana AR",2008,1802,1284,713,56,518,769,1285,135509,-2,45500
"Toledo OH",2000,2273,1473,-972,176,800,-796,17,659202,13,45780
"Toledo OH",2001,9015,6536,-2373,672,2479,-1701,205,659407,-573,45780
"Toledo OH",2002,8564,6148,-3613,621,2416,-2992,-1092,658315,-516,45780
"Toledo OH",2003,8520,6133,-2740,526,2387,-2214,-561,657754,-734,45780
"Toledo OH",2004,8856,6227,-3872,524,2629,-3348,-1263,656491,-544,45780
"Toledo OH",2005,8558,6009,-4680,530,2549,-4150,-2131,654360,-530,45780
"Toledo OH",2006,8724,6079,-5551,559,2645,-4992,-2613,651747,-266,45780
"Toledo OH",2007,8810,6057,-4273,496,2753,-3777,-977,650770,47,45780
"Toledo OH",2008,8892,5936,-5237,498,2956,-4739,-1666,649104,117,45780
"Topeka KS",2000,753,511,-76,58,242,-18,238,224787,14,45820
"Topeka KS",2001,3035,2323,-642,230,712,-412,96,224883,-204,45820
"Topeka KS",2002,3095,2304,-705,198,791,-507,94,224977,-190,45820
"Topeka KS",2003,3149,2244,-183,117,905,-66,529,225506,-310,45820
"Topeka KS",2004,3166,2153,-296,215,1013,-81,756,226262,-176,45820
"Topeka KS",2005,3205,2138,-280,180,1067,-100,763,227025,-204,45820
"Topeka KS",2006,3170,2253,-735,202,917,-533,276,227301,-108,45820
"Topeka KS",2007,3305,2109,-340,166,1196,-174,994,228295,-28,45820
"Topeka KS",2008,3375,2115,-127,182,1260,55,1324,229619,9,45820
"Trenton-Ewing NJ",2000,1125,654,-311,586,471,275,773,351534,27,45940
"Trenton-Ewing NJ",2001,4745,2950,-1287,2287,1795,1000,2460,353994,-335,45940
"Trenton-Ewing NJ",2002,4447,2927,-1139,2164,1520,1025,2219,356213,-326,45940
"Trenton-Ewing NJ",2003,4650,2805,-539,1918,1845,1379,2684,358897,-540,45940
"Trenton-Ewing NJ",2004,4584,2931,-493,1759,1653,1266,2686,361583,-233,45940
"Trenton-Ewing NJ",2005,4435,2906,-2262,1838,1529,-424,785,362368,-320,45940
"Trenton-Ewing NJ",2006,4599,2874,-2578,1917,1725,-661,895,363263,-169,45940
"Trenton-Ewing NJ",2007,4737,2870,-3062,1753,1867,-1309,494,363757,-64,45940
"Trenton-Ewing NJ",2008,4757,2744,-2589,1756,2013,-833,1126,364883,-54,45940
"Tucson AZ",2000,2973,1696,2548,1000,1277,3548,4807,848549,-18,46060
"Tucson AZ",2001,12383,7409,4573,3405,4974,7978,17111,865660,4159,46060
"Tucson AZ",2002,12287,7739,9135,2916,4548,12051,20137,885797,3538,46060
"Tucson AZ",2003,12627,7716,6614,1962,4911,8576,16976,902773,3489,46060
"Tucson AZ",2004,12988,7817,8526,2955,5171,11481,20554,923327,3902,46060
"Tucson AZ",2005,12999,7797,12168,2660,5202,14828,24206,947533,4176,46060
"Tucson AZ",2006,13325,8077,14200,2876,5248,17076,26588,974121,4264,46060
"Tucson AZ",2007,14223,7746,9480,2393,6477,11873,22472,996593,4122,46060
"Tucson AZ",2008,14337,8151,7021,2509,6186,9530,15425,1012018,-291,46060
"Tulsa OK",2000,3175,1739,-146,529,1436,383,1800,861333,-19,46140
"Tulsa OK",2001,13113,7961,-88,1948,5152,1860,6237,867570,-775,46140
"Tulsa OK",2002,13152,8022,744,1813,5130,2557,6972,874542,-715,46140
"Tulsa OK",2003,13077,8087,-3849,1526,4990,-2323,1973,876515,-694,46140
"Tulsa OK",2004,13112,8130,-5425,1481,4982,-3944,161,876676,-877,46140
"Tulsa OK",2005,13118,8303,-1239,1514,4815,275,4323,880999,-767,46140
"Tulsa OK",2006,13253,8467,4297,1553,4786,5850,10186,891185,-450,46140
"Tulsa OK",2007,14018,8248,5976,1391,5770,7367,13160,904345,23,46140
"Tulsa OK",2008,14111,8321,4366,1405,5790,5771,11734,916079,173,46140
"Tuscaloosa AL",2000,667,395,-51,65,272,14,303,193408,17,46220
"Tuscaloosa AL",2001,2672,1755,-405,247,917,-158,573,193981,-186,46220
"Tuscaloosa AL",2002,2635,1813,-860,227,822,-633,23,194004,-166,46220
"Tuscaloosa AL",2003,2483,1878,-68,189,605,121,452,194456,-274,46220
"Tuscaloosa AL",2004,2513,1853,278,196,660,474,986,195442,-148,46220
"Tuscaloosa AL",2005,2559,1768,1883,196,791,2079,2693,198135,-177,46220
"Tuscaloosa AL",2006,2613,1794,3323,202,819,3525,4240,202375,-104,46220
"Tuscaloosa AL",2007,2733,1750,951,185,983,1136,2123,204498,4,46220
"Tuscaloosa AL",2008,2822,1868,1074,184,954,1258,2267,206765,55,46220
"Tyler TX",2000,639,390,397,153,249,550,789,175495,-10,46340
"Tyler TX",2001,2658,1824,744,592,834,1336,1993,177488,-177,46340
"Tyler TX",2002,2713,1739,1618,557,974,2175,3014,180502,-135,46340
"Tyler TX",2003,2807,1702,1365,501,1105,1866,2797,183299,-174,46340
"Tyler TX",2004,2899,1674,1311,454,1225,1765,2835,186134,-155,46340
"Tyler TX",2005,2892,1642,2231,483,1250,2714,3795,189929,-169,46340
"Tyler TX",2006,2938,1487,2549,478,1451,3027,4373,194302,-105,46340
"Tyler TX",2007,3133,1721,1793,430,1412,2223,3650,197952,15,46340
"Tyler TX",2008,3243,1770,1381,432,1473,1813,3325,201277,39,46340
"Utica-Rome NY",2000,796,753,-729,209,43,-520,-481,299415,-4,46540
"Utica-Rome NY",2001,3158,3413,-2039,786,-255,-1253,-1757,297658,-249,46540
"Utica-Rome NY",2002,3151,3402,-1414,723,-251,-691,-1195,296463,-253,46540
"Utica-Rome NY",2003,3264,3215,-782,610,49,-172,-510,295953,-387,46540
"Utica-Rome NY",2004,3328,3351,-366,623,-23,257,29,295982,-205,46540
"Utica-Rome NY",2005,3222,3156,-1498,632,66,-866,-1074,294908,-274,46540
"Utica-Rome NY",2006,3240,3105,-1540,670,135,-870,-863,294045,-128,46540
"Utica-Rome NY",2007,3255,3108,-778,589,147,-189,13,294058,55,46540
"Utica-Rome NY",2008,3436,3106,-1369,598,330,-771,-268,293790,173,46540
"Valdosta GA",2000,429,240,-90,71,189,-19,171,119737,1,46660
"Valdosta GA",2001,1763,999,-775,134,764,-641,12,119749,-111,46660
"Valdosta GA",2002,1731,945,1050,-12,786,1038,1737,121486,-87,46660
"Valdosta GA",2003,1822,1030,588,-334,792,254,923,122409,-123,46660
"Valdosta GA",2004,2082,1078,839,314,1004,1153,2046,124455,-111,46660
"Valdosta GA",2005,1919,978,734,92,941,826,1664,126119,-103,46660
"Valdosta GA",2006,2123,981,875,214,1142,1089,2162,128281,-69,46660
"Valdosta GA",2007,2115,1046,589,72,1069,661,1681,129962,-49,46660
"Valdosta GA",2008,2157,1040,2176,128,1117,2304,3386,133348,-35,46660
"Vallejo-Fairfield CA",2000,1447,626,1045,565,821,1610,2426,396971,-5,46700
"Vallejo-Fairfield CA",2001,5879,2571,2412,1628,3308,4040,6984,403955,-364,46700
"Vallejo-Fairfield CA",2002,5843,2569,29,1200,3274,1229,4084,408039,-419,46700
"Vallejo-Fairfield CA",2003,5856,2706,-2315,309,3150,-2006,695,408734,-449,46700
"Vallejo-Fairfield CA",2004,5749,2686,-4324,1762,3063,-2562,116,408850,-385,46700
"Vallejo-Fairfield CA",2005,5629,2705,-5476,1326,2924,-4150,-1581,407269,-355,46700
"Vallejo-Fairfield CA",2006,5810,2741,-4612,1533,3069,-3079,-184,407085,-174,46700
"Vallejo-Fairfield CA",2007,5838,2833,-4281,1128,3005,-3153,-43,407042,105,46700
"Vallejo-Fairfield CA",2008,5834,2822,-3932,1298,3012,-2634,473,407515,95,46700
"Victoria TX",2000,412,229,-249,36,183,-213,-28,111640,2,47020
"Victoria TX",2001,1772,904,-298,213,868,-85,670,112310,-113,47020
"Victoria TX",2002,1795,959,-1068,208,836,-860,-98,112212,-74,47020
"Victoria TX",2003,1761,937,-761,180,824,-581,136,112348,-107,47020
"Victoria TX",2004,1733,964,-711,174,769,-537,137,112485,-95,47020
"Victoria TX",2005,1667,1003,-1024,177,664,-847,-279,112206,-96,47020
"Victoria TX",2006,1743,1031,-554,178,712,-376,284,112490,-52,47020
"Victoria TX",2007,1796,966,36,155,830,191,1032,113522,11,47020
"Victoria TX",2008,1801,1005,-197,157,796,-40,791,114313,35,47020
"Vineland-Millville-Bridgeton NJ",2000,437,325,-310,113,112,-197,-83,146351,2,47220
"Vineland-Millville-Bridgeton NJ",2001,2075,1462,-691,488,613,-203,284,146635,-126,47220
"Vineland-Millville-Bridgeton NJ",2002,2146,1575,0,466,571,466,890,147525,-147,47220
"Vineland-Millville-Bridgeton NJ",2003,2088,1473,289,427,615,716,1131,148656,-200,47220
"Vineland-Millville-Bridgeton NJ",2004,2214,1624,635,391,590,1026,1504,150160,-112,47220
"Vineland-Millville-Bridgeton NJ",2005,2332,1422,1102,414,910,1516,2280,152440,-146,47220
"Vineland-Millville-Bridgeton NJ",2006,2352,1492,209,492,860,701,1486,153926,-75,47220
"Vineland-Millville-Bridgeton NJ",2007,2551,1337,-173,418,1214,245,1481,155407,22,47220
"Vineland-Millville-Bridgeton NJ",2008,2582,1410,-240,419,1172,179,1423,156830,72,47220
"Virginia Beach-Norfolk-Newport News VA-NC",2000,5524,2822,-835,1510,2702,675,3378,1580294,1,47260
"Virginia Beach-Norfolk-Newport News VA-NC",2001,23363,11953,-4711,1046,11410,-3665,6839,1587133,-906,47260
"Virginia Beach-Norfolk-Newport News VA-NC",2002,23068,12134,12208,-3855,10934,8353,18435,1605568,-852,47260
"Virginia Beach-Norfolk-Newport News VA-NC",2003,23361,12329,22181,-13170,11032,9011,19761,1625329,-282,47260
"Virginia Beach-Norfolk-Newport News VA-NC",2004,24051,12344,332,7496,11707,7828,18291,1643620,-1244,47260
"Virginia Beach-Norfolk-Newport News VA-NC",2005,23848,12295,-4659,-48,11553,-4707,5784,1649404,-1062,47260
"Virginia Beach-Norfolk-Newport News VA-NC",2006,24195,11935,-3727,4183,12260,456,12239,1661643,-477,47260
"Virginia Beach-Norfolk-Newport News VA-NC",2007,24430,12481,-14556,122,11949,-14434,-1964,1659679,521,47260
"Virginia Beach-Norfolk-Newport News VA-NC",2008,24674,12595,-15523,1545,12079,-13978,-1387,1658292,512,47260
"Visalia-Porterville CA",2000,1689,657,-1016,642,1032,-374,674,368695,16,47300
"Visalia-Porterville CA",2001,7282,2693,-2647,2537,4589,-110,4174,372869,-305,47300
"Visalia-Porterville CA",2002,7282,2677,-686,2400,4605,1714,5955,378824,-364,47300
"Visalia-Porterville CA",2003,7585,2718,1879,2089,4867,3968,8390,387214,-445,47300
"Visalia-Porterville CA",2004,7765,2691,2264,1895,5074,4159,8906,396120,-327,47300
"Visalia-Porterville CA",2005,8200,2692,1904,1997,5508,3901,9022,405142,-387,47300
"Visalia-Porterville CA",2006,8099,2780,-185,1986,5319,1801,6906,412048,-214,47300
"Visalia-Porterville CA",2007,8574,2801,-454,1805,5773,1351,7124,419172,0,47300
"Visalia-Porterville CA",2008,8956,2760,-1054,1809,6196,755,7104,426276,153,47300
"Waco TX",2000,806,506,77,172,300,249,566,214085,17,47380
"Waco TX",2001,3291,1972,-267,635,1319,368,1484,215569,-203,47380
"Waco TX",2002,3221,1967,86,593,1254,679,1723,217292,-210,47380
"Waco TX",2003,3372,1893,614,505,1479,1119,2299,219591,-299,47380
"Waco TX",2004,3323,2074,1336,485,1249,1821,2883,222474,-187,47380
"Waco TX",2005,3310,1960,-98,505,1350,407,1537,224011,-220,47380
"Waco TX",2006,3471,2015,-157,514,1456,357,1704,225715,-109,47380
"Waco TX",2007,3473,2029,171,457,1444,628,2091,227806,19,47380
"Waco TX",2008,3594,1955,219,462,1639,681,2407,230213,87,47380
"Warner Robins GA",2000,413,199,159,107,214,266,484,111249,4,47580
"Warner Robins GA",2001,1668,774,1137,104,894,1241,2025,113274,-110,47580
"Warner Robins GA",2002,1659,864,2488,-152,795,2336,3090,116364,-41,47580
"Warner Robins GA",2003,1766,841,3295,-713,925,2582,3595,119959,88,47580
"Warner Robins GA",2004,1856,819,2470,453,1037,2923,3801,123760,-159,47580
"Warner Robins GA",2005,1922,867,1042,62,1055,1104,2042,125802,-117,47580
"Warner Robins GA",2006,1972,865,869,273,1107,1142,2184,127986,-65,47580
"Warner Robins GA",2007,2020,899,1804,28,1121,1832,2986,130972,33,47580
"Warner Robins GA",2008,2024,940,974,124,1084,1098,2189,133161,7,47580
"Washington-Arlington-Alexandria DC-VA-MD-WV",2000,18206,6964,3490,10404,11242,13894,25130,4821195,-6,47900
"Washington-Arlington-Alexandria DC-VA-MD-WV",2001,74082,29786,15922,38132,44296,54054,106920,4928115,8570,47900
"Washington-Arlington-Alexandria DC-VA-MD-WV",2002,74782,30511,1296,33480,44271,34776,86230,5014345,7183,47900
"Washington-Arlington-Alexandria DC-VA-MD-WV",2003,75789,30033,-8500,24643,45756,16143,70261,5084606,8362,47900
"Washington-Arlington-Alexandria DC-VA-MD-WV",2004,77763,30853,-14535,32068,46910,17533,69842,5154448,5399,47900
"Washington-Arlington-Alexandria DC-VA-MD-WV",2005,78746,30337,-16790,29807,48409,13017,67446,5221894,6020,47900
"Washington-Arlington-Alexandria DC-VA-MD-WV",2006,80061,29973,-45148,31879,50088,-13269,37903,5259797,1084,47900
"Washington-Arlington-Alexandria DC-VA-MD-WV",2007,79547,30700,-35337,27244,48847,-8093,42498,5302295,1744,47900
"Washington-Arlington-Alexandria DC-VA-MD-WV",2008,78386,31276,-18259,27975,47110,9716,55835,5358130,-991,47900
"Waterloo-Cedar Falls IA",2000,471,325,-314,108,146,-206,-66,163641,-6,47940
"Waterloo-Cedar Falls IA",2001,1929,1543,-1006,422,386,-584,-327,163314,-129,47940
"Waterloo-Cedar Falls IA",2002,1970,1508,-1938,392,462,-1546,-1181,162133,-97,47940
"Waterloo-Cedar Falls IA",2003,1932,1430,-1214,345,502,-869,-517,161616,-150,47940
"Waterloo-Cedar Falls IA",2004,2037,1537,-438,324,500,-114,264,161880,-122,47940
"Waterloo-Cedar Falls IA",2005,2083,1499,-444,338,584,-106,327,162207,-151,47940
"Waterloo-Cedar Falls IA",2006,2098,1422,-320,342,676,22,618,162825,-80,47940
"Waterloo-Cedar Falls IA",2007,2224,1399,-868,302,825,-566,249,163074,-10,47940
"Waterloo-Cedar Falls IA",2008,2204,1400,27,300,804,327,1146,164220,15,47940
"Wausau WI",2000,384,237,-110,29,147,-81,73,125909,7,48140
"Wausau WI",2001,1566,908,-428,110,658,-318,226,126135,-114,48140
"Wausau WI",2002,1515,996,-332,104,519,-228,178,126313,-113,48140
"Wausau WI",2003,1561,993,-382,87,568,-295,105,126418,-168,48140
"Wausau WI",2004,1522,937,-261,81,585,-180,319,126737,-86,48140
"Wausau WI",2005,1482,958,343,88,524,431,831,127568,-124,48140
"Wausau WI",2006,1582,933,559,89,649,648,1235,128803,-62,48140
"Wausau WI",2007,1791,985,84,73,806,157,980,129783,17,48140
"Wausau WI",2008,1717,996,342,73,721,415,1179,130962,43,48140
"Weirton-Steubenville WV-OH",2000,381,387,-362,3,-6,-359,-377,131631,-12,48260
"Weirton-Steubenville WV-OH",2001,1374,1773,-901,19,-399,-882,-1386,130245,-105,48260
"Weirton-Steubenville WV-OH",2002,1229,1804,-696,15,-575,-681,-1360,128885,-104,48260
"Weirton-Steubenville WV-OH",2003,1302,1723,-522,5,-421,-517,-1096,127789,-158,48260
"Weirton-Steubenville WV-OH",2004,1256,1780,-682,22,-524,-660,-1279,126510,-95,48260
"Weirton-Steubenville WV-OH",2005,1335,1764,-686,14,-429,-672,-1211,125299,-110,48260
"Weirton-Steubenville WV-OH",2006,1284,1694,-1007,22,-410,-985,-1447,123852,-52,48260
"Weirton-Steubenville WV-OH",2007,1251,1700,-873,16,-449,-857,-1301,122551,5,48260
"Weirton-Steubenville WV-OH",2008,1261,1686,-77,16,-425,-61,-497,122054,-11,48260
"Wenatchee WA",2000,357,189,-139,111,168,-28,145,99361,5,48300
"Wenatchee WA",2001,1413,786,-951,466,627,-485,67,99428,-75,48300
"Wenatchee WA",2002,1358,810,-492,441,548,-51,413,99841,-84,48300
"Wenatchee WA",2003,1367,852,10,390,515,400,781,100622,-134,48300
"Wenatchee WA",2004,1352,883,540,355,469,895,1287,101909,-77,48300
"Wenatchee WA",2005,1402,818,441,375,584,816,1326,103235,-74,48300
"Wenatchee WA",2006,1447,833,808,371,614,1179,1732,104967,-61,48300
"Wenatchee WA",2007,1525,895,887,336,630,1223,1762,106729,-91,48300
"Wenatchee WA",2008,1531,910,623,340,621,963,1464,108193,-120,48300
"Wheeling WV-OH",2000,381,426,-290,4,-45,-286,-340,152838,-9,48540
"Wheeling WV-OH",2001,1510,1912,-1032,40,-402,-992,-1523,151315,-129,48540
"Wheeling WV-OH",2002,1538,1866,-242,36,-328,-206,-655,150660,-121,48540
"Wheeling WV-OH",2003,1454,1881,-639,27,-427,-612,-1219,149441,-180,48540
"Wheeling WV-OH",2004,1576,1993,-357,31,-417,-326,-849,148592,-106,48540
"Wheeling WV-OH",2005,1533,1956,-620,28,-423,-592,-1143,147449,-128,48540
"Wheeling WV-OH",2006,1535,1770,-506,31,-235,-475,-777,146672,-67,48540
"Wheeling WV-OH",2007,1475,1828,-558,30,-353,-528,-908,145764,-27,48540
"Wheeling WV-OH",2008,1529,1806,-646,27,-277,-619,-917,144847,-21,48540
"Wichita Falls TX",2000,496,311,-281,161,185,-120,60,151584,-5,48660
"Wichita Falls TX",2001,2040,1521,-2025,137,519,-1888,-1469,150115,-100,48660
"Wichita Falls TX",2002,2099,1472,-49,-279,627,-328,161,150276,-138,48660
"Wichita Falls TX",2003,2076,1451,1133,-1182,625,-49,452,150728,-124,48660
"Wichita Falls TX",2004,2157,1426,-1097,755,731,-342,258,150986,-131,48660
"Wichita Falls TX",2005,2071,1551,-1766,106,520,-1660,-1255,149731,-115,48660
"Wichita Falls TX",2006,2145,1470,-1473,430,675,-1043,-437,149294,-69,48660
"Wichita Falls TX",2007,2105,1396,-2062,21,709,-2041,-1374,147920,-42,48660
"Wichita Falls TX",2008,2203,1440,-1469,197,763,-1272,-592,147328,-83,48660
"Wichita KS",2000,2298,1142,-793,452,1156,-341,845,572016,30,48620
"Wichita KS",2001,9198,4866,-2868,1517,4332,-1351,2480,574496,-501,48620
"Wichita KS",2002,8997,4797,-852,1265,4200,413,4086,578582,-527,48620
"Wichita KS",2003,9064,5024,-2992,777,4040,-2215,1189,579771,-636,48620
"Wichita KS",2004,9091,5013,-3468,1343,4078,-2125,1451,581222,-502,48620
"Wichita KS",2005,9216,5039,-2262,1168,4177,-1094,2569,583791,-514,48620
"Wichita KS",2006,9314,4998,-1094,1293,4316,199,4229,588020,-286,48620
"Wichita KS",2007,9899,4895,1250,1039,5004,2289,7301,595321,8,48620
"Wichita KS",2008,9982,4970,2137,1101,5012,3238,8395,603716,145,48620
"Williamsport PA",2000,363,326,-138,6,37,-132,-90,119958,5,48700
"Williamsport PA",2001,1294,1218,-834,19,76,-815,-843,119115,-104,48700
"Williamsport PA",2002,1284,1196,-601,13,88,-588,-596,118519,-96,48700
"Williamsport PA",2003,1297,1241,-173,-2,56,-175,-281,118238,-162,48700
"Williamsport PA",2004,1351,1243,-213,18,108,-195,-166,118072,-79,48700
"Williamsport PA",2005,1334,1293,-327,11,41,-316,-389,117683,-114,48700
"Williamsport PA",2006,1397,1265,-541,17,132,-524,-441,117242,-49,48700
"Williamsport PA",2007,1359,1207,-581,9,152,-572,-407,116835,13,48700
"Williamsport PA",2008,1396,1237,-377,10,159,-367,-165,116670,43,48700
"Wilmington NC",2000,787,593,973,123,194,1096,1288,275840,-2,48900
"Wilmington NC",2001,3461,2499,4558,490,962,5048,5835,281675,-175,48900
"Wilmington NC",2002,3366,2539,5321,427,827,5748,6457,288132,-118,48900
"Wilmington NC",2003,3348,2550,5103,231,798,5334,6081,294213,-51,48900
"Wilmington NC",2004,3410,2675,9101,421,735,9522,9771,303984,-486,48900
"Wilmington NC",2005,3745,2783,11206,376,962,11582,12287,316271,-257,48900
"Wilmington NC",2006,3982,2762,10873,416,1220,11289,12318,328589,-191,48900
"Wilmington NC",2007,4237,2847,8310,335,1390,8645,10191,338780,156,48900
"Wilmington NC",2008,4375,2926,6321,360,1449,6681,8232,347012,102,48900
"Winchester VA-WV",2000,343,189,371,47,154,418,568,103564,-4,49020
"Winchester VA-WV",2001,1367,908,1725,191,459,1916,2301,105865,-74,49020
"Winchester VA-WV",2002,1347,874,1747,176,473,1923,2329,108194,-67,49020
"Winchester VA-WV",2003,1429,911,1447,138,518,1585,2082,110276,-21,49020
"Winchester VA-WV",2004,1529,919,1876,149,610,2025,2504,112780,-131,49020
"Winchester VA-WV",2005,1558,962,2351,148,596,2499,2993,115773,-102,49020
"Winchester VA-WV",2006,1596,968,2159,155,628,2314,2881,118654,-61,49020
"Winchester VA-WV",2007,1740,974,1338,134,766,1472,2253,120907,15,49020
"Winchester VA-WV",2008,1771,978,550,133,793,683,1462,122369,-14,49020
"Winston-Salem NC",2000,1497,876,311,420,621,731,1369,423332,17,49180
"Winston-Salem NC",2001,6081,3895,1275,1708,2186,2983,4771,428103,-398,49180
"Winston-Salem NC",2002,6009,3888,983,1618,2121,2601,4317,432420,-405,49180
"Winston-Salem NC",2003,5918,3943,-112,1398,1975,1286,2625,435045,-636,49180
"Winston-Salem NC",2004,5981,3938,1216,1299,2043,2515,4228,439273,-330,49180
"Winston-Salem NC",2005,6067,4031,3510,1363,2036,4873,6488,445761,-421,49180
"Winston-Salem NC",2006,6228,3973,4569,1366,2255,5935,7961,453722,-229,49180
"Winston-Salem NC",2007,6614,3900,3883,1231,2714,5114,7893,461615,65,49180
"Winston-Salem NC",2008,6581,3957,2520,1237,2624,3757,6509,468124,128,49180
"Worcester MA",2000,2517,1562,971,714,955,1685,2683,752656,43,49340
"Worcester MA",2001,10182,6861,2858,2664,3321,5522,8160,760816,-683,49340
"Worcester MA",2002,10070,6864,1725,2495,3206,4220,6718,767534,-708,49340
"Worcester MA",2003,10053,6817,668,2184,3236,2852,4980,772514,-1108,49340
"Worcester MA",2004,10070,6708,-2144,2074,3362,-70,2740,775254,-552,49340
"Worcester MA",2005,9820,6856,-1975,2136,2964,161,2375,777629,-750,49340
"Worcester MA",2006,9858,6654,-2340,2504,3204,164,3007,780636,-361,49340
"Worcester MA",2007,9928,6530,-4192,2221,3398,-1971,1507,782143,80,49340
"Worcester MA",2008,9977,6605,-4183,2227,3372,-1956,1663,783806,247,49340
"Yakima WA",2000,1064,413,-810,303,651,-507,147,222726,3,49420
"Yakima WA",2001,4276,1617,-3536,1171,2659,-2365,153,222879,-141,49420
"Yakima WA",2002,4072,1735,-2686,1099,2337,-1587,606,223485,-144,49420
"Yakima WA",2003,3995,1705,-1437,953,2290,-484,1561,225046,-245,49420
"Yakima WA",2004,4335,1801,-1175,886,2534,-289,2061,227107,-184,49420
"Yakima WA",2005,4123,1804,-1920,925,2319,-995,1115,228222,-209,49420
"Yakima WA",2006,4303,1813,-1394,930,2490,-464,1917,230139,-109,49420
"Yakima WA",2007,4304,1746,-1563,842,2558,-721,1882,232021,45,49420
"Yakima WA",2008,4392,1756,-1013,846,2636,-167,2543,234564,74,49420
"York-Hanover PA",2000,1109,744,482,81,365,563,956,382709,28,49620
"York-Hanover PA",2001,4581,3408,1449,308,1173,1757,2588,385297,-342,49620
"York-Hanover PA",2002,4656,3287,2095,273,1369,2368,3411,388708,-326,49620
"York-Hanover PA",2003,4611,3292,3446,212,1319,3658,4651,393359,-326,49620
"York-Hanover PA",2004,4935,3416,4426,243,1519,4669,5794,399153,-394,49620
"York-Hanover PA",2005,4905,3486,5697,233,1419,5930,6968,406121,-381,49620
"York-Hanover PA",2006,5056,3395,6062,337,1661,6399,7852,413973,-208,49620
"York-Hanover PA",2007,5299,3440,4127,274,1859,4401,6412,420385,152,49620
"York-Hanover PA",2008,5433,3478,1792,277,1955,2069,4198,424583,174,49620
"Youngstown-Warren-Boardman OH-PA",2000,1778,1660,-976,42,118,-934,-806,602157,10,49660
"Youngstown-Warren-Boardman OH-PA",2001,7058,7028,-3384,198,30,-3186,-3667,598490,-511,49660
"Youngstown-Warren-Boardman OH-PA",2002,6532,6965,-4015,184,-433,-3831,-4741,593749,-477,49660
"Youngstown-Warren-Boardman OH-PA",2003,6211,6715,-2794,143,-504,-2651,-3851,589898,-696,49660
"Youngstown-Warren-Boardman OH-PA",2004,6472,6936,-3355,181,-464,-3174,-4106,585792,-468,49660
"Youngstown-Warren-Boardman OH-PA",2005,6244,6993,-3830,162,-749,-3668,-4918,580874,-501,49660
"Youngstown-Warren-Boardman OH-PA",2006,6332,6765,-4189,221,-433,-3968,-4653,576221,-252,49660
"Youngstown-Warren-Boardman OH-PA",2007,6374,6792,-5511,188,-418,-5323,-5704,570517,37,49660
"Youngstown-Warren-Boardman OH-PA",2008,6375,6671,-4456,189,-296,-4267,-4570,565947,-7,49660
"Yuba City CA",2000,528,280,-194,250,248,56,308,139457,4,49700
"Yuba City CA",2001,2247,1262,174,783,985,957,1809,141266,-133,49700
"Yuba City CA",2002,2260,1219,1341,608,1041,1949,2885,144151,-105,49700
"Yuba City CA",2003,2552,1256,1926,215,1296,2141,3362,147513,-75,49700
"Yuba City CA",2004,2509,1294,598,806,1215,1404,2501,150014,-118,49700
"Yuba City CA",2005,2679,1241,2735,638,1438,3373,4664,154678,-147,49700
"Yuba City CA",2006,2741,1184,2933,721,1557,3654,5123,159801,-88,49700
"Yuba City CA",2007,3055,1210,1115,536,1845,1651,3501,163302,5,49700
"Yuba City CA",2008,3117,1235,-544,607,1882,63,1972,165274,27,49700
"Yuma AZ",2000,648,207,-122,360,441,238,687,160713,8,49740
"Yuma AZ",2001,2963,1002,-413,1119,1961,706,2505,163218,-162,49740
"Yuma AZ",2002,3099,1102,168,870,1997,1038,2879,166097,-156,49740
"Yuma AZ",2003,3133,1138,971,376,1995,1347,3175,169272,-167,49740
"Yuma AZ",2004,3255,1194,1641,1109,2061,2750,4643,173915,-168,49740
"Yuma AZ",2005,3406,1187,3156,880,2219,4036,6094,180009,-161,49740
"Yuma AZ",2006,3303,1294,2189,1015,2009,3204,5104,185113,-109,49740
"Yuma AZ",2007,3324,1156,1512,781,2168,2293,4497,189610,36,49740
"Yuma AZ",2008,3553,1291,1501,857,2262,2358,4712,194322,92,49740
